OBJECTID_1,COUNT,AREA,MIN,MAX,RANGE,MEAN,STD,SUM,VARIETY,MAJORITY,MAJORITY_COUNT,MAJORITY_PERCENT,MINORITY,MINORITY_COUNT,MINORITY_PERCENT,MEDIAN,PCT90
1,4.000000000000000,0.000277777777778,796,2502,1706,1682.000000000000000,607.787791914250306,6728.000000000000000,4,796,1,25.0000000,796,1,25.0000000,1620,2502
2,4.000000000000000,0.000277777777778,52,2203,2151,746.500000000000000,862.798499071480819,2986.000000000000000,4,52,1,25.0000000,52,1,25.0000000,161,2203
3,5.000000000000000,0.000347222222222,174,1299,1125,686.000000000000000,398.337545305485833,3430.000000000000000,5,174,1,20.0000000,174,1,20.0000000,537,1299
4,3.000000000000000,0.000208333333333,453,1299,846,906.333333333333258,348.031927015643532,2719.000000000000000,3,453,1,33.3333015,453,1,33.3333015,967,1299
5,4.000000000000000,0.000277777777778,453,1299,846,814.000000000000000,341.205216841712399,3256.000000000000000,4,453,1,25.0000000,453,1,25.0000000,537,1299
6,4.000000000000000,0.000277777777778,40,759,719,338.000000000000000,280.277541019611476,1352.000000000000000,4,40,1,25.0000000,40,1,25.0000000,134,759
7,3.000000000000000,0.000208333333333,1007,3338,2331,2010.333333333333485,978.871572554620457,6031.000000000000000,3,1007,1,33.3333015,1007,1,33.3333015,1686,3338
8,4.000000000000000,0.000277777777778,250,18653,18403,6740.250000000000000,7072.082415208409657,26961.000000000000000,4,250,1,25.0000000,250,1,25.0000000,3217,18653
9,4.000000000000000,0.000277777777778,200,2058,1858,1137.500000000000000,763.081417674418276,4550.000000000000000,4,200,1,25.0000000,200,1,25.0000000,597,2058
10,3.000000000000000,0.000208333333333,0,0,0,0.000000000000000,0.000000000000000,0.000000000000000,1,0,3,100.0000000,0,3,100.0000000,0,0
11,4.000000000000000,0.000277777777778,603,1102,499,828.500000000000000,183.622574864856972,3314.000000000000000,4,603,1,25.0000000,603,1,25.0000000,741,1102
12,4.000000000000000,0.000277777777778,480,2095,1615,1172.500000000000000,599.293959589115161,4690.000000000000000,4,480,1,25.0000000,480,1,25.0000000,858,2095
13,4.000000000000000,0.000277777777778,28,2283,2255,1019.250000000000000,925.784363391389320,4077.000000000000000,4,28,1,25.0000000,28,1,25.0000000,246,2283
14,4.000000000000000,0.000277777777778,28,2283,2255,1019.250000000000000,925.784363391389320,4077.000000000000000,4,28,1,25.0000000,28,1,25.0000000,246,2283
15,4.000000000000000,0.000277777777778,710,1545,835,1015.750000000000000,335.561749161015086,4063.000000000000000,4,710,1,25.0000000,710,1,25.0000000,743,1545
16,4.000000000000000,0.000277777777778,76,595,519,230.250000000000000,212.057038317524359,921.000000000000000,4,76,1,25.0000000,76,1,25.0000000,104,595
17,4.000000000000000,0.000277777777778,14,2281,2267,822.500000000000000,864.890889072141817,3290.000000000000000,4,14,1,25.0000000,14,1,25.0000000,497,2281
18,5.000000000000000,0.000347222222222,14,2281,2267,688.799999999999955,818.493591911384442,3444.000000000000000,5,14,1,20.0000000,14,1,20.0000000,497,2281
19,5.000000000000000,0.000347222222222,33,582,549,364.000000000000000,227.665544165119542,1820.000000000000000,5,33,1,20.0000000,33,1,20.0000000,490,582
20,4.000000000000000,0.000277777777778,66,1487,1421,562.500000000000000,570.085300634913779,2250.000000000000000,4,66,1,25.0000000,66,1,25.0000000,117,1487
21,4.000000000000000,0.000277777777778,102,2169,2067,760.750000000000000,831.855268361029289,3043.000000000000000,4,102,1,25.0000000,102,1,25.0000000,199,2169
22,4.000000000000000,0.000277777777778,0,3174,3174,899.750000000000000,1323.978167304884209,3599.000000000000000,4,0,1,25.0000000,0,1,25.0000000,6,3174
23,4.000000000000000,0.000277777777778,907,5068,4161,2037.500000000000227,1754.884682821068054,8150.000000000000000,4,907,1,25.0000000,907,1,25.0000000,927,5068
24,3.000000000000000,0.000208333333333,61,571,510,341.666666666666686,211.347002712495453,1025.000000000000000,3,61,1,33.3333015,61,1,33.3333015,393,571
25,3.000000000000000,0.000208333333333,61,571,510,305.666666666666629,208.718843316926126,917.000000000000000,3,61,1,33.3333015,61,1,33.3333015,285,571
26,3.000000000000000,0.000208333333333,523,1682,1159,1065.000000000000000,476.122533248182492,3195.000000000000000,3,523,1,33.3333015,523,1,33.3333015,990,1682
27,3.000000000000000,0.000208333333333,853,2835,1982,1571.000000000000000,896.537041435916649,4713.000000000000000,3,853,1,33.3333015,853,1,33.3333015,1025,2835
28,4.000000000000000,0.000277777777778,507,2995,2488,1229.750000000000000,1024.756403980965615,4919.000000000000000,4,507,1,25.0000000,507,1,25.0000000,612,2995
29,4.000000000000000,0.000277777777778,507,2995,2488,1229.750000000000000,1024.756403980965615,4919.000000000000000,4,507,1,25.0000000,507,1,25.0000000,612,2995
30,4.000000000000000,0.000277777777778,507,2995,2488,1229.750000000000000,1024.756403980965615,4919.000000000000000,4,507,1,25.0000000,507,1,25.0000000,612,2995
31,4.000000000000000,0.000277777777778,14,498,484,254.000000000000000,212.433519012419509,1016.000000000000000,4,14,1,25.0000000,14,1,25.0000000,74,498
32,5.000000000000000,0.000347222222222,308,4095,3787,1253.400000000000091,1427.641495614357837,6267.000000000000000,5,308,1,20.0000000,308,1,20.0000000,616,4095
33,5.000000000000000,0.000347222222222,23,429,406,178.400000000000006,142.645855179882489,892.000000000000000,5,23,1,20.0000000,23,1,20.0000000,131,429
34,4.000000000000000,0.000277777777778,12,1620,1608,452.500000000000000,676.925586752340223,1810.000000000000000,4,12,1,25.0000000,12,1,25.0000000,13,1620
35,3.000000000000000,0.000208333333333,200,1227,1027,795.666666666666629,435.075727763442217,2387.000000000000000,3,200,1,33.3333015,200,1,33.3333015,960,1227
36,4.000000000000000,0.000277777777778,2,1280,1278,540.500000000000000,484.004906999918774,2162.000000000000000,4,2,1,25.0000000,2,1,25.0000000,240,1280
37,3.000000000000000,0.000208333333333,185,777,592,531.666666666666742,252.081115692724779,1595.000000000000000,3,185,1,33.3333015,185,1,33.3333015,633,777
38,3.000000000000000,0.000208333333333,1147,3676,2529,2451.666666666666515,1034.021383832182664,7355.000000000000000,3,1147,1,33.3333015,1147,1,33.3333015,2532,3676
39,4.000000000000000,0.000277777777778,536,4355,3819,2365.250000000000000,1725.002373186773411,9461.000000000000000,4,536,1,25.0000000,536,1,25.0000000,771,4355
40,4.000000000000000,0.000277777777778,536,4355,3819,2365.250000000000000,1725.002373186773411,9461.000000000000000,4,536,1,25.0000000,536,1,25.0000000,771,4355
41,4.000000000000000,0.000277777777778,344,1071,727,701.750000000000000,307.280307699663695,2807.000000000000000,4,344,1,25.0000000,344,1,25.0000000,458,1071
42,4.000000000000000,0.000277777777778,86,1424,1338,749.250000000000000,510.824517324687520,2997.000000000000000,4,86,1,25.0000000,86,1,25.0000000,471,1424
43,4.000000000000000,0.000277777777778,2,280,278,111.250000000000014,108.044840228490330,445.000000000000000,4,2,1,25.0000000,2,1,25.0000000,34,280
44,4.000000000000000,0.000277777777778,614,1759,1145,907.750000000000000,491.607249234589688,3631.000000000000000,4,614,1,25.0000000,614,1,25.0000000,615,1759
45,4.000000000000000,0.000277777777778,9,1077,1068,479.750000000000057,475.373208647689864,1919.000000000000000,4,9,1,25.0000000,9,1,25.0000000,18,1077
46,4.000000000000000,0.000277777777778,189,4103,3914,1802.500000000000227,1500.679429458537015,7210.000000000000000,4,189,1,25.0000000,189,1,25.0000000,797,4103
47,4.000000000000000,0.000277777777778,465,3256,2791,1201.500000000000000,1186.950820379682000,4806.000000000000000,4,465,1,25.0000000,465,1,25.0000000,501,3256
48,4.000000000000000,0.000277777777778,465,738,273,572.000000000000000,105.107088248129131,2288.000000000000000,4,465,1,25.0000000,465,1,25.0000000,501,738
49,4.000000000000000,0.000277777777778,427,1301,874,882.000000000000000,320.763152497290434,3528.000000000000000,4,427,1,25.0000000,427,1,25.0000000,781,1301
50,4.000000000000000,0.000277777777778,427,1301,874,882.000000000000000,320.763152497290434,3528.000000000000000,4,427,1,25.0000000,427,1,25.0000000,781,1301
51,4.000000000000000,0.000277777777778,404,913,509,718.500000000000000,199.752972443465779,2874.000000000000000,4,404,1,25.0000000,404,1,25.0000000,690,913
52,4.000000000000000,0.000277777777778,27,84,57,56.250000000000000,23.847169643376969,225.000000000000000,4,27,1,25.0000000,27,1,25.0000000,39,84
53,4.000000000000000,0.000277777777778,327,1745,1418,750.500000000000000,577.123253733550428,3002.000000000000000,4,327,1,25.0000000,327,1,25.0000000,444,1745
54,4.000000000000000,0.000277777777778,327,1745,1418,750.500000000000000,577.123253733550428,3002.000000000000000,4,327,1,25.0000000,327,1,25.0000000,444,1745
55,4.000000000000000,0.000277777777778,63,1975,1912,667.250000000000000,762.070329759662059,2669.000000000000000,4,63,1,25.0000000,63,1,25.0000000,305,1975
56,4.000000000000000,0.000277777777778,52,573,521,251.500000000000000,216.719288481667007,1006.000000000000000,4,52,1,25.0000000,52,1,25.0000000,54,573
57,5.000000000000000,0.000347222222222,447,3656,3209,1167.400000000000091,1248.005224348039292,5837.000000000000000,5,447,1,20.0000000,447,1,20.0000000,504,3656
58,4.000000000000000,0.000277777777778,795,5183,4388,2061.000000000000000,1814.811284954995017,8244.000000000000000,4,795,1,25.0000000,795,1,25.0000000,907,5183
59,4.000000000000000,0.000277777777778,483,1393,910,998.000000000000000,328.689823389772755,3992.000000000000000,4,483,1,25.0000000,483,1,25.0000000,1015,1393
60,5.000000000000000,0.000347222222222,53,1476,1423,407.199999999999989,539.020370672574813,2036.000000000000000,5,53,1,20.0000000,53,1,20.0000000,196,1476
61,3.000000000000000,0.000208333333333,53,196,143,107.333333333333343,63.226225219884476,322.000000000000000,3,53,1,33.3333015,53,1,33.3333015,73,196
62,4.000000000000000,0.000277777777778,384,1792,1408,1097.000000000000000,579.731834558013588,4388.000000000000000,4,384,1,25.0000000,384,1,25.0000000,686,1792
63,4.000000000000000,0.000277777777778,53,898,845,509.500000000000000,303.140643926214580,2038.000000000000000,4,53,1,25.0000000,53,1,25.0000000,489,898
64,4.000000000000000,0.000277777777778,53,898,845,509.500000000000000,303.140643926214580,2038.000000000000000,4,53,1,25.0000000,53,1,25.0000000,489,898
65,4.000000000000000,0.000277777777778,24,2257,2233,742.250000000000000,891.453412972321303,2969.000000000000000,4,24,1,25.0000000,24,1,25.0000000,184,2257
66,5.000000000000000,0.000347222222222,330,1219,889,679.200000000000045,349.549653125274915,3396.000000000000000,5,330,1,20.0000000,330,1,20.0000000,453,1219
67,3.000000000000000,0.000208333333333,453,1219,766,879.666666666666629,318.757309284386793,2639.000000000000000,3,453,1,33.3333015,453,1,33.3333015,967,1219
68,4.000000000000000,0.000277777777778,321,35388,35067,11595.000000000000000,13939.944278941720768,46380.000000000000000,4,321,1,25.0000000,321,1,25.0000000,3645,35388
69,4.000000000000000,0.000277777777778,3967,15328,11361,7089.500000000000000,4764.085877689444715,28358.000000000000000,4,3967,1,25.0000000,3967,1,25.0000000,4336,15328
70,4.000000000000000,0.000277777777778,392,699,307,513.500000000000000,113.204461042840535,2054.000000000000000,4,392,1,25.0000000,392,1,25.0000000,477,699
71,4.000000000000000,0.000277777777778,21,1011,990,466.500000000000000,358.935579178214084,1866.000000000000000,4,21,1,25.0000000,21,1,25.0000000,329,1011
72,4.000000000000000,0.000277777777778,21,1041,1020,435.999999999999943,390.541931167448411,1744.000000000000000,4,21,1,25.0000000,21,1,25.0000000,177,1041
73,4.000000000000000,0.000277777777778,669,1763,1094,1096.750000000000000,437.134061244373868,4387.000000000000000,4,669,1,25.0000000,669,1,25.0000000,744,1763
74,4.000000000000000,0.000277777777778,288,7124,6836,2697.000000000000000,2656.669531575201290,10788.000000000000000,4,288,1,25.0000000,288,1,25.0000000,1058,7124
75,4.000000000000000,0.000277777777778,301,1347,1046,657.250000000000000,408.723852374681030,2629.000000000000000,4,301,1,25.0000000,301,1,25.0000000,420,1347
76,4.000000000000000,0.000277777777778,730,1083,353,902.750000000000000,127.154187898000430,3611.000000000000000,4,730,1,25.0000000,730,1,25.0000000,865,1083
77,4.000000000000000,0.000277777777778,61,571,510,366.500000000000000,188.017951270616720,1466.000000000000000,4,61,1,25.0000000,61,1,25.0000000,393,571
78,4.000000000000000,0.000277777777778,33,3494,3461,1310.750000000000000,1304.721498060026533,5243.000000000000000,4,33,1,25.0000000,33,1,25.0000000,857,3494
79,3.000000000000000,0.000208333333333,15,74,59,45.666666666666671,24.143091949642425,137.000000000000000,3,15,1,33.3333015,15,1,33.3333015,48,74
80,4.000000000000000,0.000277777777778,10,543,533,258.000000000000000,235.700021213405932,1032.000000000000000,4,10,1,25.0000000,10,1,25.0000000,41,543
81,4.000000000000000,0.000277777777778,122,1214,1092,570.750000000000000,406.862000560386548,2283.000000000000000,4,122,1,25.0000000,122,1,25.0000000,355,1214
82,4.000000000000000,0.000277777777778,19,2460,2441,774.500000000000000,989.343848214562854,3098.000000000000000,4,19,1,25.0000000,19,1,25.0000000,121,2460
83,4.000000000000000,0.000277777777778,72,1410,1338,529.750000000000000,519.728955802926180,2119.000000000000000,4,72,1,25.0000000,72,1,25.0000000,260,1410
84,3.000000000000000,0.000208333333333,198,1205,1007,847.333333333333371,459.937918516063291,2542.000000000000000,3,198,1,33.3333015,198,1,33.3333015,1139,1205
85,4.000000000000000,0.000277777777778,44,5021,4977,1598.750000000000000,1992.037446309682309,6395.000000000000000,4,44,1,25.0000000,44,1,25.0000000,661,5021
86,4.000000000000000,0.000277777777778,2,4,2,2.500000000000000,0.866025403784439,10.000000000000000,2,2,3,75.0000000,4,1,25.0000000,2,4
87,4.000000000000000,0.000277777777778,2698,81771,79073,29507.500000000000000,31142.773499641934905,118030.000000000000000,4,2698,1,25.0000000,2698,1,25.0000000,9524,81771
88,5.000000000000000,0.000347222222222,0,700,700,346.600000000000023,294.035099945567708,1733.000000000000000,5,0,1,20.0000000,0,1,20.0000000,436,700
89,4.000000000000000,0.000277777777778,0,594,594,272.000000000000000,250.179935246614065,1088.000000000000000,4,0,1,25.0000000,0,1,25.0000000,58,594
90,4.000000000000000,0.000277777777778,719,2711,1992,1233.000000000000000,853.424864882667976,4932.000000000000000,4,719,1,25.0000000,719,1,25.0000000,749,2711
91,4.000000000000000,0.000277777777778,778,1590,812,1128.500000000000000,350.765234879399088,4514.000000000000000,4,778,1,25.0000000,778,1,25.0000000,799,1590
92,4.000000000000000,0.000277777777778,162,7614,7452,3216.750000000000000,3166.508280030229344,12867.000000000000000,4,162,1,25.0000000,162,1,25.0000000,250,7614
93,4.000000000000000,0.000277777777778,375,630,255,476.750000000000000,94.027589036409950,1907.000000000000000,4,375,1,25.0000000,375,1,25.0000000,441,630
94,4.000000000000000,0.000277777777778,25,42,17,29.250000000000000,7.361215932167728,117.000000000000000,2,25,3,75.0000000,42,1,25.0000000,25,42
95,4.000000000000000,0.000277777777778,327,1745,1418,750.500000000000000,577.123253733550428,3002.000000000000000,4,327,1,25.0000000,327,1,25.0000000,444,1745
96,4.000000000000000,0.000277777777778,685,3135,2450,1399.500000000000000,1006.464480247564438,5598.000000000000000,4,685,1,25.0000000,685,1,25.0000000,825,3135
97,3.000000000000000,0.000208333333333,5,954,949,327.333333333333371,443.181176896712941,982.000000000000000,3,5,1,33.3333015,5,1,33.3333015,23,954
98,4.000000000000000,0.000277777777778,30,1377,1347,565.750000000000000,506.106893353568125,2263.000000000000000,4,30,1,25.0000000,30,1,25.0000000,284,1377
99,5.000000000000000,0.000347222222222,250,2186,1936,1001.399999999999977,734.201498227836737,5007.000000000000000,5,250,1,20.0000000,250,1,20.0000000,661,2186
100,5.000000000000000,0.000347222222222,4,906,902,556.799999999999955,312.606717778105292,2784.000000000000000,5,4,1,20.0000000,4,1,20.0000000,543,906
101,4.000000000000000,0.000277777777778,213,820,607,425.250000000000000,233.587644150969595,1701.000000000000000,4,213,1,25.0000000,213,1,25.0000000,315,820
102,4.000000000000000,0.000277777777778,248,555,307,392.500000000000000,109.166157759628049,1570.000000000000000,4,248,1,25.0000000,248,1,25.0000000,373,555
103,4.000000000000000,0.000277777777778,516,665,149,576.250000000000000,57.815979625013703,2305.000000000000000,4,516,1,25.0000000,516,1,25.0000000,535,665
104,4.000000000000000,0.000277777777778,794,2274,1480,1861.250000000000000,619.062749242756468,7445.000000000000000,4,794,1,25.0000000,794,1,25.0000000,2120,2274
105,5.000000000000000,0.000347222222222,794,2274,1480,1824.799999999999955,558.484878935857978,9124.000000000000000,5,794,1,20.0000000,794,1,20.0000000,2120,2274
106,4.000000000000000,0.000277777777778,58,1733,1675,633.000000000000000,648.286587860646705,2532.000000000000000,4,58,1,25.0000000,58,1,25.0000000,334,1733
107,4.000000000000000,0.000277777777778,0,594,594,272.000000000000000,250.179935246614065,1088.000000000000000,4,0,1,25.0000000,0,1,25.0000000,58,594
108,4.000000000000000,0.000277777777778,62,2873,2811,1457.250000000000000,1128.533644824114390,5829.000000000000000,4,62,1,25.0000000,62,1,25.0000000,691,2873
109,3.000000000000000,0.000208333333333,226,1116,890,716.666666666666742,369.035981383327339,2150.000000000000000,3,226,1,33.3333015,226,1,33.3333015,808,1116
110,4.000000000000000,0.000277777777778,199,791,592,581.000000000000000,239.976040470710331,2324.000000000000000,4,199,1,25.0000000,199,1,25.0000000,554,791
111,4.000000000000000,0.000277777777778,617,1411,794,863.750000000000000,318.590155999836270,3455.000000000000000,4,617,1,25.0000000,617,1,25.0000000,698,1411
112,4.000000000000000,0.000277777777778,617,1411,794,912.000000000000000,304.120042088646301,3648.000000000000000,4,617,1,25.0000000,617,1,25.0000000,729,1411
113,4.000000000000000,0.000277777777778,5,598,593,195.500000000000000,236.669072757722205,782.000000000000000,4,5,1,25.0000000,5,1,25.0000000,49,598
114,4.000000000000000,0.000277777777778,324,1487,1163,781.000000000000000,439.121281652347193,3124.000000000000000,4,324,1,25.0000000,324,1,25.0000000,528,1487
115,4.000000000000000,0.000277777777778,5,1175,1170,539.250000000000000,531.067968813785683,2157.000000000000000,4,5,1,25.0000000,5,1,25.0000000,23,1175
116,4.000000000000000,0.000277777777778,266,1171,905,701.750000000000000,397.203584450090261,2807.000000000000000,4,266,1,25.0000000,266,1,25.0000000,353,1171
117,4.000000000000000,0.000277777777778,56,2416,2360,838.500000000000000,958.460614735942045,3354.000000000000000,4,56,1,25.0000000,56,1,25.0000000,82,2416
118,5.000000000000000,0.000347222222222,235,536,301,364.799999999999955,124.959833546624097,1824.000000000000000,5,235,1,20.0000000,235,1,20.0000000,290,536
119,4.000000000000000,0.000277777777778,352,3769,3417,1418.000000000000000,1371.056344575232970,5672.000000000000000,4,352,1,25.0000000,352,1,25.0000000,653,3769
120,4.000000000000000,0.000277777777778,199,1244,1045,832.000000000000000,403.412320089508398,3328.000000000000000,4,199,1,25.0000000,199,1,25.0000000,775,1244
121,4.000000000000000,0.000277777777778,1,426,425,214.750000000000000,178.022997109923978,859.000000000000000,4,1,1,25.0000000,1,1,25.0000000,81,426
122,3.000000000000000,0.000208333333333,1,351,350,144.333333333333343,149.740516301441346,433.000000000000000,3,1,1,33.3333015,1,1,33.3333015,81,351
123,4.000000000000000,0.000277777777778,360,1047,687,826.000000000000000,272.498623849736191,3304.000000000000000,4,360,1,25.0000000,360,1,25.0000000,926,1047
124,4.000000000000000,0.000277777777778,406,1173,767,677.000000000000000,311.090822751170208,2708.000000000000000,4,406,1,25.0000000,406,1,25.0000000,419,1173
125,4.000000000000000,0.000277777777778,61,970,909,462.750000000000000,336.375069676692874,1851.000000000000000,4,61,1,25.0000000,61,1,25.0000000,291,970
126,4.000000000000000,0.000277777777778,0,0,0,0.000000000000000,0.000000000000000,0.000000000000000,1,0,4,100.0000000,0,4,100.0000000,0,0
127,4.000000000000000,0.000277777777778,867,4824,3957,2184.000000000000000,1576.766152604754552,8736.000000000000000,4,867,1,25.0000000,867,1,25.0000000,1095,4824
128,4.000000000000000,0.000277777777778,609,1950,1341,1090.000000000000000,528.782091224731289,4360.000000000000000,4,609,1,25.0000000,609,1,25.0000000,706,1950
129,5.000000000000000,0.000347222222222,706,4824,4118,1888.400000000000091,1529.205885418964726,9442.000000000000000,5,706,1,20.0000000,706,1,20.0000000,1095,4824
130,3.000000000000000,0.000208333333333,641,1354,713,1031.333333333333258,294.987382027698857,3094.000000000000000,3,641,1,33.3333015,641,1,33.3333015,1099,1354
131,4.000000000000000,0.000277777777778,842,1771,929,1369.250000000000000,383.314736867759905,5477.000000000000000,4,842,1,25.0000000,842,1,25.0000000,1167,1771
132,5.000000000000000,0.000347222222222,169,4819,4650,1460.800000000000182,1714.592709654394866,7304.000000000000000,5,169,1,20.0000000,169,1,20.0000000,642,4819
133,4.000000000000000,0.000277777777778,0,758,758,396.500000000000000,281.437826171252254,1586.000000000000000,4,0,1,25.0000000,0,1,25.0000000,295,758
134,4.000000000000000,0.000277777777778,937,13766,12829,8783.750000000000000,4760.212514951407684,35135.000000000000000,4,937,1,25.0000000,937,1,25.0000000,9950,13766
135,4.000000000000000,0.000277777777778,122,1214,1092,570.750000000000000,406.862000560386548,2283.000000000000000,4,122,1,25.0000000,122,1,25.0000000,355,1214
136,3.000000000000000,0.000208333333333,465,584,119,516.666666666666629,49.828595092465633,1550.000000000000000,3,465,1,33.3333015,465,1,33.3333015,501,584
137,4.000000000000000,0.000277777777778,465,3256,2791,1201.500000000000000,1186.950820379682000,4806.000000000000000,4,465,1,25.0000000,465,1,25.0000000,501,3256
138,5.000000000000000,0.000347222222222,1035,5895,4860,3138.400000000000091,1648.773556313904464,15692.000000000000000,5,1035,1,20.0000000,1035,1,20.0000000,3203,5895
139,4.000000000000000,0.000277777777778,0,649,649,267.000000000000000,273.626570347252652,1068.000000000000000,4,0,1,25.0000000,0,1,25.0000000,15,649
140,4.000000000000000,0.000277777777778,0,649,649,267.000000000000000,273.626570347252652,1068.000000000000000,4,0,1,25.0000000,0,1,25.0000000,15,649
141,6.000000000000000,0.000416666666667,44,1740,1696,553.666666666666742,549.351334656510062,3322.000000000000000,6,44,1,16.6667004,44,1,16.6667004,410,451
142,4.000000000000000,0.000277777777778,489,6812,6323,3249.000000000000000,2794.547637811887398,12996.000000000000000,4,489,1,25.0000000,489,1,25.0000000,545,6812
143,4.000000000000000,0.000277777777778,427,1745,1318,990.500000000000000,572.679011314366221,3962.000000000000000,4,427,1,25.0000000,427,1,25.0000000,444,1745
144,4.000000000000000,0.000277777777778,0,9,9,3.250000000000000,3.699662146737186,13.000000000000000,3,0,2,50.0000000,4,1,25.0000000,0,9
145,4.000000000000000,0.000277777777778,228,454,226,340.750000000000000,88.406377032429063,1363.000000000000000,4,228,1,25.0000000,228,1,25.0000000,287,454
146,3.000000000000000,0.000208333333333,205,2996,2791,1963.666666666666515,1249.824076509258930,5891.000000000000000,3,205,1,33.3333015,205,1,33.3333015,2690,2996
147,3.000000000000000,0.000208333333333,191,1208,1017,686.333333333333371,415.605849600582758,2059.000000000000000,3,191,1,33.3333015,191,1,33.3333015,660,1208
148,4.000000000000000,0.000277777777778,284,2003,1719,812.250000000000000,692.342897342061292,3249.000000000000000,4,284,1,25.0000000,284,1,25.0000000,459,2003
149,4.000000000000000,0.000277777777778,281,850,569,687.000000000000000,235.181844537370722,2748.000000000000000,4,281,1,25.0000000,281,1,25.0000000,796,850
150,4.000000000000000,0.000277777777778,281,850,569,687.000000000000000,235.181844537370722,2748.000000000000000,4,281,1,25.0000000,281,1,25.0000000,796,850
151,5.000000000000000,0.000347222222222,0,837,837,453.000000000000000,366.708058269790399,2265.000000000000000,5,0,1,20.0000000,0,1,20.0000000,687,837
152,4.000000000000000,0.000277777777778,616,2274,1658,1340.750000000000000,672.600689488198441,5363.000000000000000,4,616,1,25.0000000,616,1,25.0000000,794,2274
153,4.000000000000000,0.000277777777778,241,432,191,332.000000000000000,74.635782303128565,1328.000000000000000,4,241,1,25.0000000,241,1,25.0000000,283,432
154,3.000000000000000,0.000208333333333,1008,2032,1024,1422.333333333333258,440.272895170963523,4267.000000000000000,3,1008,1,33.3333015,1008,1,33.3333015,1227,2032
155,4.000000000000000,0.000277777777778,92,807,715,373.750000000000000,263.956790971552778,1495.000000000000000,4,92,1,25.0000000,92,1,25.0000000,290,807
156,4.000000000000000,0.000277777777778,140,2385,2245,1350.500000000000000,817.846104105167228,5402.000000000000000,4,140,1,25.0000000,140,1,25.0000000,1189,2385
157,4.000000000000000,0.000277777777778,133,909,776,594.250000000000000,302.030937984836271,2377.000000000000000,4,133,1,25.0000000,133,1,25.0000000,522,909
158,3.000000000000000,0.000208333333333,620,1621,1001,1180.666666666666742,417.420917327129416,3542.000000000000000,3,620,1,33.3333015,620,1,33.3333015,1301,1621
159,5.000000000000000,0.000347222222222,329,2320,1991,1004.799999999999955,701.078141151184468,5024.000000000000000,5,329,1,20.0000000,329,1,20.0000000,859,2320
160,4.000000000000000,0.000277777777778,98,537,439,317.750000000000000,179.317281654613538,1271.000000000000000,4,98,1,25.0000000,98,1,25.0000000,191,537
161,3.000000000000000,0.000208333333333,410,1197,787,679.333333333333371,366.145993954445601,2038.000000000000000,3,410,1,33.3333015,410,1,33.3333015,431,1197
162,3.000000000000000,0.000208333333333,577,1698,1121,1068.333333333333258,467.983143096225490,3205.000000000000000,3,577,1,33.3333015,577,1,33.3333015,930,1698
163,3.000000000000000,0.000208333333333,577,1698,1121,1068.333333333333258,467.983143096225490,3205.000000000000000,3,577,1,33.3333015,577,1,33.3333015,930,1698
164,3.000000000000000,0.000208333333333,195,551,356,366.333333333333371,145.641874320387529,1099.000000000000000,3,195,1,33.3333015,195,1,33.3333015,353,551
165,4.000000000000000,0.000277777777778,837,1556,719,1077.000000000000000,287.030486185701193,4308.000000000000000,4,837,1,25.0000000,837,1,25.0000000,874,1556
166,2.000000000000000,0.000138888888889,121,498,377,309.500000000000000,188.500000000000000,619.000000000000000,2,121,1,50.0000000,121,1,50.0000000,121,498
167,3.000000000000000,0.000208333333333,84,2270,2186,1170.000000000000000,892.485667485291629,3510.000000000000000,3,84,1,33.3333015,84,1,33.3333015,1156,2270
168,4.000000000000000,0.000277777777778,156,741,585,407.750000000000000,211.732584880079344,1631.000000000000000,4,156,1,25.0000000,156,1,25.0000000,339,741
169,4.000000000000000,0.000277777777778,156,741,585,407.750000000000000,211.732584880079344,1631.000000000000000,4,156,1,25.0000000,156,1,25.0000000,339,741
170,4.000000000000000,0.000277777777778,2106,2701,595,2443.000000000000000,214.859256258602898,9772.000000000000000,4,2106,1,25.0000000,2106,1,25.0000000,2456,2701
171,4.000000000000000,0.000277777777778,608,1579,971,1014.000000000000000,353.088515814377615,4056.000000000000000,4,608,1,25.0000000,608,1,25.0000000,903,1579
172,4.000000000000000,0.000277777777778,318,1753,1435,1022.500000000000000,519.591426026257636,4090.000000000000000,4,318,1,25.0000000,318,1,25.0000000,852,1753
173,5.000000000000000,0.000347222222222,322,802,480,455.000000000000000,176.218046748907085,2275.000000000000000,5,322,1,20.0000000,322,1,20.0000000,394,802
174,4.000000000000000,0.000277777777778,764,1228,464,944.750000000000000,184.918056176242573,3779.000000000000000,4,764,1,25.0000000,764,1,25.0000000,797,1228
175,4.000000000000000,0.000277777777778,598,3243,2645,1514.750000000000000,1022.847343204253548,6059.000000000000000,4,598,1,25.0000000,598,1,25.0000000,990,3243
176,4.000000000000000,0.000277777777778,764,1228,464,944.750000000000000,184.918056176242573,3779.000000000000000,4,764,1,25.0000000,764,1,25.0000000,797,1228
177,5.000000000000000,0.000347222222222,523,3243,2720,1356.200000000000045,971.337099054699934,6781.000000000000000,5,523,1,20.0000000,523,1,20.0000000,990,3243
178,4.000000000000000,0.000277777777778,6,327,321,151.250000000000000,145.523838253394075,605.000000000000000,4,6,1,25.0000000,6,1,25.0000000,9,327
179,3.000000000000000,0.000208333333333,177,1800,1623,892.000000000000000,676.495380619853108,2676.000000000000000,3,177,1,33.3333015,177,1,33.3333015,699,1800
180,6.000000000000000,0.000416666666667,130,4095,3965,1143.666666666666515,1338.520534852649234,6862.000000000000000,6,130,1,16.6667004,130,1,16.6667004,616,825
181,4.000000000000000,0.000277777777778,166,1960,1794,1321.000000000000000,685.615781615330093,5284.000000000000000,4,166,1,25.0000000,166,1,25.0000000,1530,1960
182,5.000000000000000,0.000347222222222,513,979,466,709.000000000000000,177.339222959840441,3545.000000000000000,5,513,1,20.0000000,513,1,20.0000000,621,979
183,4.000000000000000,0.000277777777778,794,3612,2818,1901.750000000000000,1144.636705465974501,7607.000000000000000,4,794,1,25.0000000,794,1,25.0000000,927,3612
184,4.000000000000000,0.000277777777778,104,868,764,530.000000000000000,317.631862381594203,2120.000000000000000,4,104,1,25.0000000,104,1,25.0000000,346,868
185,4.000000000000000,0.000277777777778,48,721,673,313.250000000000000,281.717389417124934,1253.000000000000000,4,48,1,25.0000000,48,1,25.0000000,54,721
186,4.000000000000000,0.000277777777778,431,848,417,686.250000000000000,162.830241355836620,2745.000000000000000,4,431,1,25.0000000,431,1,25.0000000,661,848
187,3.000000000000000,0.000208333333333,485,851,366,690.333333333333371,152.720514520988843,2071.000000000000000,3,485,1,33.3333015,485,1,33.3333015,735,851
188,4.000000000000000,0.000277777777778,212,4533,4321,2000.250000000000227,1574.540627452972558,8001.000000000000000,4,212,1,25.0000000,212,1,25.0000000,1512,4533
189,4.000000000000000,0.000277777777778,324,624,300,512.250000000000000,113.045068446173275,2049.000000000000000,4,324,1,25.0000000,324,1,25.0000000,539,624
190,4.000000000000000,0.000277777777778,406,1831,1425,972.250000000000000,594.663928198104145,3889.000000000000000,4,406,1,25.0000000,406,1,25.0000000,430,1831
191,4.000000000000000,0.000277777777778,22,278,256,130.500000000000000,92.718660473499071,522.000000000000000,4,22,1,25.0000000,22,1,25.0000000,104,278
192,5.000000000000000,0.000347222222222,677,4344,3667,1619.000000000000000,1373.629935608568530,8095.000000000000000,4,1126,2,40.0000000,677,1,20.0000000,1126,4344
193,4.000000000000000,0.000277777777778,1239,15922,14683,8576.250000000000000,6586.972535808844441,34305.000000000000000,4,1239,1,25.0000000,1239,1,25.0000000,2838,15922
194,4.000000000000000,0.000277777777778,240,1228,988,563.250000000000000,389.863678097870491,2253.000000000000000,4,240,1,25.0000000,240,1,25.0000000,352,1228
195,4.000000000000000,0.000277777777778,536,4355,3819,2365.250000000000000,1725.002373186773411,9461.000000000000000,4,536,1,25.0000000,536,1,25.0000000,771,4355
196,4.000000000000000,0.000277777777778,183,494,311,334.000000000000000,145.449303882830606,1336.000000000000000,4,183,1,25.0000000,183,1,25.0000000,195,494
197,4.000000000000000,0.000277777777778,646,1475,829,1061.500000000000000,305.429615459928812,4246.000000000000000,4,646,1,25.0000000,646,1,25.0000000,941,1475
198,4.000000000000000,0.000277777777778,6,1019,1013,373.000000000000000,407.985906619334116,1492.000000000000000,4,6,1,25.0000000,6,1,25.0000000,40,1019
199,4.000000000000000,0.000277777777778,6,1019,1013,373.000000000000000,407.985906619334116,1492.000000000000000,4,6,1,25.0000000,6,1,25.0000000,40,1019
200,4.000000000000000,0.000277777777778,392,510,118,458.500000000000000,43.095823463532980,1834.000000000000000,4,392,1,25.0000000,392,1,25.0000000,455,510
201,4.000000000000000,0.000277777777778,27,1299,1272,362.000000000000000,541.517312742630565,1448.000000000000000,4,27,1,25.0000000,27,1,25.0000000,33,1299
202,4.000000000000000,0.000277777777778,32,1012,980,513.500000000000000,347.917734529299310,2054.000000000000000,4,32,1,25.0000000,32,1,25.0000000,462,1012
203,3.000000000000000,0.000208333333333,1,82,81,33.000000000000000,35.185224171518364,99.000000000000000,3,1,1,33.3333015,1,1,33.3333015,16,82
204,4.000000000000000,0.000277777777778,55,2891,2836,997.500000000000000,1112.792321145324877,3990.000000000000000,4,55,1,25.0000000,55,1,25.0000000,405,2891
205,3.000000000000000,0.000208333333333,189,407,218,268.666666666666686,98.191423024394325,806.000000000000000,3,189,1,33.3333015,189,1,33.3333015,210,407
206,4.000000000000000,0.000277777777778,446,1276,830,938.000000000000000,352.201646787745744,3752.000000000000000,4,446,1,25.0000000,446,1,25.0000000,762,1276
207,3.000000000000000,0.000208333333333,16,106,90,46.000000000000000,42.426406871192853,138.000000000000000,2,16,2,66.6667023,106,1,33.3333015,16,106
208,4.000000000000000,0.000277777777778,325,1832,1507,845.000000000000000,607.276296260606614,3380.000000000000000,4,325,1,25.0000000,325,1,25.0000000,365,1832
209,4.000000000000000,0.000277777777778,352,605,253,470.500000000000000,89.962492184243089,1882.000000000000000,4,352,1,25.0000000,352,1,25.0000000,455,605
210,6.000000000000000,0.000416666666667,447,3656,3209,1051.500000000000000,1168.372764432082477,6309.000000000000000,6,447,1,16.6667004,447,1,16.6667004,503,727
211,4.000000000000000,0.000277777777778,366,2001,1635,1193.250000000000000,579.017001045737857,4773.000000000000000,4,366,1,25.0000000,366,1,25.0000000,1158,2001
212,4.000000000000000,0.000277777777778,598,3243,2645,1514.750000000000000,1022.847343204253548,6059.000000000000000,4,598,1,25.0000000,598,1,25.0000000,990,3243
213,4.000000000000000,0.000277777777778,0,2437,2437,849.000000000000000,993.368763350247491,3396.000000000000000,4,0,1,25.0000000,0,1,25.0000000,15,2437
214,4.000000000000000,0.000277777777778,263,1697,1434,1061.000000000000000,555.522726807823801,4244.000000000000000,4,263,1,25.0000000,263,1,25.0000000,842,1697
215,4.000000000000000,0.000277777777778,921,4144,3223,2430.250000000000000,1329.948001803078114,9721.000000000000000,4,921,1,25.0000000,921,1,25.0000000,1369,4144
216,4.000000000000000,0.000277777777778,602,2598,1996,1336.750000000000000,770.478868950992023,5347.000000000000000,4,602,1,25.0000000,602,1,25.0000000,844,2598
217,5.000000000000000,0.000347222222222,43,261,218,182.199999999999989,79.159080338265682,911.000000000000000,5,43,1,20.0000000,43,1,20.0000000,214,261
218,4.000000000000000,0.000277777777778,510,893,383,667.000000000000000,155.818805026864453,2668.000000000000000,4,510,1,25.0000000,510,1,25.0000000,535,893
219,4.000000000000000,0.000277777777778,595,11574,10979,4400.000000000000000,4384.372418032026872,17600.000000000000000,4,595,1,25.0000000,595,1,25.0000000,1092,11574
220,4.000000000000000,0.000277777777778,1006,2063,1057,1487.750000000000000,378.694715437118305,5951.000000000000000,4,1006,1,25.0000000,1006,1,25.0000000,1385,2063
221,4.000000000000000,0.000277777777778,430,5305,4875,2094.750000000000000,1987.406271374828748,8379.000000000000000,4,430,1,25.0000000,430,1,25.0000000,448,5305
222,4.000000000000000,0.000277777777778,430,2711,2281,1521.500000000000000,956.293495742807977,6086.000000000000000,4,430,1,25.0000000,430,1,25.0000000,749,2711
223,4.000000000000000,0.000277777777778,203,938,735,594.000000000000000,263.451133988829156,2376.000000000000000,4,203,1,25.0000000,203,1,25.0000000,566,938
224,4.000000000000000,0.000277777777778,334,1760,1426,1200.750000000000000,534.159795847647160,4803.000000000000000,4,334,1,25.0000000,334,1,25.0000000,1232,1760
225,3.000000000000000,0.000208333333333,177,713,536,433.333333333333314,219.442222210970357,1300.000000000000000,3,177,1,33.3333015,177,1,33.3333015,410,713
226,4.000000000000000,0.000277777777778,122,2297,2175,841.500000000000000,856.605656063512129,3366.000000000000000,4,122,1,25.0000000,122,1,25.0000000,355,2297
227,5.000000000000000,0.000347222222222,8,439,431,111.600000000000009,164.655519190824549,558.000000000000000,5,8,1,20.0000000,8,1,20.0000000,34,439
228,4.000000000000000,0.000277777777778,64046,94332,30286,74711.500000000000000,11892.140629424124199,298846.000000000000000,4,64046,1,25.0000000,64046,1,25.0000000,66568,94332
229,4.000000000000000,0.000277777777778,29,1293,1264,347.250000000000000,546.034969118279037,1389.000000000000000,4,29,1,25.0000000,29,1,25.0000000,31,1293
230,4.000000000000000,0.000277777777778,316,830,514,542.000000000000000,187.579316557023418,2168.000000000000000,4,316,1,25.0000000,316,1,25.0000000,462,830
231,3.000000000000000,0.000208333333333,47,1973,1926,741.666666666666742,873.070189363693430,2225.000000000000000,3,47,1,33.3333015,47,1,33.3333015,205,1973
232,4.000000000000000,0.000277777777778,1007,1969,962,1434.250000000000000,406.490697925549114,5737.000000000000000,4,1007,1,25.0000000,1007,1,25.0000000,1075,1969
233,4.000000000000000,0.000277777777778,1007,1969,962,1434.250000000000000,406.490697925549114,5737.000000000000000,4,1007,1,25.0000000,1007,1,25.0000000,1075,1969
234,4.000000000000000,0.000277777777778,31,3886,3855,2086.750000000000000,1534.684556350261801,8347.000000000000000,4,31,1,25.0000000,31,1,25.0000000,1234,3886
235,4.000000000000000,0.000277777777778,425,5515,5090,1906.750000000000000,2093.335660494990861,7627.000000000000000,4,425,1,25.0000000,425,1,25.0000000,682,5515
236,4.000000000000000,0.000277777777778,19,2460,2441,1150.750000000000000,912.297751559215499,4603.000000000000000,4,19,1,25.0000000,19,1,25.0000000,663,2460
237,4.000000000000000,0.000277777777778,1047,2651,1604,1910.000000000000000,730.298226753974859,7640.000000000000000,4,1047,1,25.0000000,1047,1,25.0000000,1326,2651
238,4.000000000000000,0.000277777777778,25,28,3,25.750000000000000,1.299038105676658,103.000000000000000,2,25,3,75.0000000,28,1,25.0000000,25,28
239,4.000000000000000,0.000277777777778,731,2789,2058,1432.750000000000000,814.154891590046304,5731.000000000000000,4,731,1,25.0000000,731,1,25.0000000,876,2789
240,4.000000000000000,0.000277777777778,117,1146,1029,731.250000000000000,385.457114994651533,2925.000000000000000,4,117,1,25.0000000,117,1,25.0000000,719,1146
241,4.000000000000000,0.000277777777778,500,716,216,610.750000000000000,100.586716319800402,2443.000000000000000,4,500,1,25.0000000,500,1,25.0000000,521,716
242,5.000000000000000,0.000347222222222,1075,29662,28587,8721.399999999999636,11036.046875580042979,43607.000000000000000,5,1075,1,20.0000000,1075,1,20.0000000,1477,29662
243,4.000000000000000,0.000277777777778,464,1567,1103,1031.250000000000000,429.630291646201329,4125.000000000000000,4,464,1,25.0000000,464,1,25.0000000,793,1567
244,4.000000000000000,0.000277777777778,59,863,804,391.500000000000000,343.721907943034694,1566.000000000000000,4,59,1,25.0000000,59,1,25.0000000,67,863
245,4.000000000000000,0.000277777777778,0,174,174,80.750000000000000,81.232305765625043,323.000000000000000,3,0,2,50.0000000,149,1,25.0000000,0,174
246,4.000000000000000,0.000277777777778,0,174,174,80.750000000000000,81.232305765625043,323.000000000000000,3,0,2,50.0000000,149,1,25.0000000,0,174
247,3.000000000000000,0.000208333333333,53,256,203,173.333333333333343,87.049155972677610,520.000000000000000,3,53,1,33.3333015,53,1,33.3333015,211,256
248,4.000000000000000,0.000277777777778,35,1842,1807,636.250000000000000,718.256004151723005,2545.000000000000000,4,35,1,25.0000000,35,1,25.0000000,153,1842
249,4.000000000000000,0.000277777777778,333,4531,4198,2137.750000000000000,1651.099236115140457,8551.000000000000000,4,333,1,25.0000000,333,1,25.0000000,909,4531
250,4.000000000000000,0.000277777777778,436,1128,692,761.500000000000000,292.558968414916308,3046.000000000000000,4,436,1,25.0000000,436,1,25.0000000,516,1128
251,4.000000000000000,0.000277777777778,433,1439,1006,807.500000000000000,401.331222308955148,3230.000000000000000,4,433,1,25.0000000,433,1,25.0000000,489,1439
252,4.000000000000000,0.000277777777778,0,227,227,104.000000000000000,82.507575409776763,416.000000000000000,4,0,1,25.0000000,0,1,25.0000000,71,227
253,4.000000000000000,0.000277777777778,0,227,227,104.000000000000000,82.507575409776763,416.000000000000000,4,0,1,25.0000000,0,1,25.0000000,71,227
254,4.000000000000000,0.000277777777778,0,227,227,104.000000000000000,82.507575409776763,416.000000000000000,4,0,1,25.0000000,0,1,25.0000000,71,227
255,3.000000000000000,0.000208333333333,1041,2265,1224,1462.000000000000000,568.029928788967936,4386.000000000000000,3,1041,1,33.3333015,1041,1,33.3333015,1080,2265
256,4.000000000000000,0.000277777777778,209,499,290,320.250000000000000,114.615389455343205,1281.000000000000000,4,209,1,25.0000000,209,1,25.0000000,232,499
257,4.000000000000000,0.000277777777778,176,3140,2964,1302.250000000000000,1109.475636280490789,5209.000000000000000,4,176,1,25.0000000,176,1,25.0000000,835,3140
258,3.000000000000000,0.000208333333333,714,4418,3704,2052.333333333333485,1677.590401604502404,6157.000000000000000,3,714,1,33.3333015,714,1,33.3333015,1025,4418
259,4.000000000000000,0.000277777777778,62,2873,2811,1457.250000000000000,1128.533644824114390,5829.000000000000000,4,62,1,25.0000000,62,1,25.0000000,691,2873
260,4.000000000000000,0.000277777777778,444,720,276,522.000000000000000,114.919537068333170,2088.000000000000000,4,444,1,25.0000000,444,1,25.0000000,449,720
261,5.000000000000000,0.000347222222222,0,986,986,230.400000000000006,379.457296675133136,1152.000000000000000,5,0,1,20.0000000,0,1,20.0000000,38,986
262,4.000000000000000,0.000277777777778,399,1005,606,707.250000000000000,214.317958883524284,2829.000000000000000,4,399,1,25.0000000,399,1,25.0000000,712,1005
263,4.000000000000000,0.000277777777778,160,3196,3036,1148.250000000000000,1234.057205926856568,4593.000000000000000,4,160,1,25.0000000,160,1,25.0000000,194,3196
264,4.000000000000000,0.000277777777778,391,1911,1520,1107.000000000000000,544.780689819306986,4428.000000000000000,4,391,1,25.0000000,391,1,25.0000000,953,1911
265,4.000000000000000,0.000277777777778,265,1071,806,774.750000000000000,309.197651187715223,3099.000000000000000,4,265,1,25.0000000,265,1,25.0000000,804,1071
266,4.000000000000000,0.000277777777778,538,3332,2794,2108.500000000000000,1124.130219325145617,8434.000000000000000,4,538,1,25.0000000,538,1,25.0000000,1564,3332
267,3.000000000000000,0.000208333333333,221,972,751,686.000000000000000,331.693633744554518,2058.000000000000000,3,221,1,33.3333015,221,1,33.3333015,865,972
268,3.000000000000000,0.000208333333333,108,1847,1739,696.333333333333258,813.713435771805166,2089.000000000000000,3,108,1,33.3333015,108,1,33.3333015,134,1847
269,4.000000000000000,0.000277777777778,6,1847,1841,563.250000000000000,748.226361136788569,2253.000000000000000,4,6,1,25.0000000,6,1,25.0000000,108,1847
270,4.000000000000000,0.000277777777778,458,8607,8149,5250.750000000000000,3278.003384302706763,21003.000000000000000,4,458,1,25.0000000,458,1,25.0000000,4005,8607
271,4.000000000000000,0.000277777777778,603,1906,1303,1218.250000000000000,462.342608354453944,4873.000000000000000,4,603,1,25.0000000,603,1,25.0000000,1161,1906
272,4.000000000000000,0.000277777777778,518,2387,1869,1438.750000000000000,836.882421550363347,5755.000000000000000,4,518,1,25.0000000,518,1,25.0000000,699,2387
273,6.000000000000000,0.000416666666667,462,3614,3152,1568.333333333333485,1080.877215762991227,9410.000000000000000,6,462,1,16.6667004,462,1,16.6667004,970,2085
274,4.000000000000000,0.000277777777778,60,1629,1569,555.750000000000000,626.767251457827797,2223.000000000000000,4,60,1,25.0000000,60,1,25.0000000,208,1629
275,4.000000000000000,0.000277777777778,612,1470,858,1105.250000000000000,310.877286883426052,4421.000000000000000,4,612,1,25.0000000,612,1,25.0000000,1138,1470
276,3.000000000000000,0.000208333333333,123,860,737,519.000000000000000,303.382047370418206,1557.000000000000000,3,123,1,33.3333015,123,1,33.3333015,574,860
277,4.000000000000000,0.000277777777778,114,524,410,340.000000000000000,154.160630512462575,1360.000000000000000,4,114,1,25.0000000,114,1,25.0000000,293,524
278,4.000000000000000,0.000277777777778,55,5093,5038,1870.250000000000227,1918.505847658536823,7481.000000000000000,4,55,1,25.0000000,55,1,25.0000000,1007,5093
279,4.000000000000000,0.000277777777778,480,1832,1352,1240.500000000000000,587.088366432175235,4962.000000000000000,4,480,1,25.0000000,480,1,25.0000000,858,1832
280,5.000000000000000,0.000347222222222,325,1832,1507,1034.400000000000091,662.206191453991096,5172.000000000000000,5,325,1,20.0000000,325,1,20.0000000,858,1832
281,4.000000000000000,0.000277777777778,140,977,837,495.000000000000000,312.060090367224007,1980.000000000000000,4,140,1,25.0000000,140,1,25.0000000,324,977
282,4.000000000000000,0.000277777777778,180,796,616,419.000000000000000,229.376328334028386,1676.000000000000000,4,180,1,25.0000000,180,1,25.0000000,321,796
283,4.000000000000000,0.000277777777778,867,4824,3957,2195.250000000000000,1569.098049039638681,8781.000000000000000,4,867,1,25.0000000,867,1,25.0000000,1140,4824
284,4.000000000000000,0.000277777777778,739,7512,6773,4336.250000000000000,2403.906963153940524,17345.000000000000000,4,739,1,25.0000000,739,1,25.0000000,4529,7512
285,4.000000000000000,0.000277777777778,94,852,758,300.250000000000000,319.355894731880596,1201.000000000000000,4,94,1,25.0000000,94,1,25.0000000,102,852
286,4.000000000000000,0.000277777777778,649,1106,457,889.000000000000000,169.901442018600903,3556.000000000000000,4,649,1,25.0000000,649,1,25.0000000,828,1106
287,4.000000000000000,0.000277777777778,187,1813,1626,1208.500000000000000,631.699889187895906,4834.000000000000000,4,187,1,25.0000000,187,1,25.0000000,1193,1813
288,4.000000000000000,0.000277777777778,168,4195,4027,2063.000000000000000,1770.343045852978094,8252.000000000000000,4,168,1,25.0000000,168,1,25.0000000,466,4195
289,5.000000000000000,0.000347222222222,83,918,835,687.399999999999977,305.249144142944317,3437.000000000000000,5,83,1,20.0000000,83,1,20.0000000,805,918
290,3.000000000000000,0.000208333333333,320,1848,1528,1030.666666666666742,628.346684208292345,3092.000000000000000,3,320,1,33.3333015,320,1,33.3333015,924,1848
291,4.000000000000000,0.000277777777778,57,124,67,83.250000000000000,28.181332473820326,333.000000000000000,3,57,2,50.0000000,95,1,25.0000000,57,124
292,4.000000000000000,0.000277777777778,57,124,67,83.250000000000000,28.181332473820326,333.000000000000000,3,57,2,50.0000000,95,1,25.0000000,57,124
293,4.000000000000000,0.000277777777778,263,1697,1434,1061.000000000000000,555.522726807823801,4244.000000000000000,4,263,1,25.0000000,263,1,25.0000000,842,1697
294,4.000000000000000,0.000277777777778,148,197,49,163.000000000000000,19.836834424877377,652.000000000000000,4,148,1,25.0000000,148,1,25.0000000,151,197
295,5.000000000000000,0.000347222222222,148,2550,2402,735.399999999999977,929.414783613861005,3677.000000000000000,5,148,1,20.0000000,148,1,20.0000000,156,2550
296,4.000000000000000,0.000277777777778,37,930,893,500.000000000000000,345.339687843722913,2000.000000000000000,4,37,1,25.0000000,37,1,25.0000000,320,930
297,4.000000000000000,0.000277777777778,33,64,31,48.500000000000000,15.500000000000000,194.000000000000000,2,33,2,50.0000000,33,2,50.0000000,33,64
298,4.000000000000000,0.000277777777778,515,4095,3580,1567.500000000000000,1466.513126432900435,6270.000000000000000,4,515,1,25.0000000,515,1,25.0000000,733,4095
299,4.000000000000000,0.000277777777778,515,4095,3580,1567.500000000000000,1466.513126432900435,6270.000000000000000,4,515,1,25.0000000,515,1,25.0000000,733,4095
300,3.000000000000000,0.000208333333333,648,795,147,719.666666666666629,60.068479439904436,2159.000000000000000,3,648,1,33.3333015,648,1,33.3333015,716,795
301,4.000000000000000,0.000277777777778,43,1698,1655,633.750000000000000,654.367394893724850,2535.000000000000000,4,43,1,25.0000000,43,1,25.0000000,153,1698
302,4.000000000000000,0.000277777777778,5337,11998,6661,7816.250000000000000,2533.840205597030035,31265.000000000000000,4,5337,1,25.0000000,5337,1,25.0000000,6418,11998
303,4.000000000000000,0.000277777777778,291,1672,1381,1210.500000000000000,540.337163260125976,4842.000000000000000,4,291,1,25.0000000,291,1,25.0000000,1392,1672
304,4.000000000000000,0.000277777777778,337,1003,666,639.750000000000000,299.617568743890558,2559.000000000000000,4,337,1,25.0000000,337,1,25.0000000,351,1003
305,4.000000000000000,0.000277777777778,21493,32177,10684,26238.500000000000000,4508.476322439766591,104954.000000000000000,4,21493,1,25.0000000,21493,1,25.0000000,22265,32177
306,4.000000000000000,0.000277777777778,808,3612,2804,1846.500000000000000,1087.326422929195587,7386.000000000000000,4,808,1,25.0000000,808,1,25.0000000,1116,3612
307,4.000000000000000,0.000277777777778,808,3612,2804,1846.500000000000000,1087.326422929195587,7386.000000000000000,4,808,1,25.0000000,808,1,25.0000000,1116,3612
308,4.000000000000000,0.000277777777778,584,2254,1670,1045.000000000000000,698.942415367675267,4180.000000000000000,4,584,1,25.0000000,584,1,25.0000000,663,2254
309,5.000000000000000,0.000347222222222,0,1534,1534,600.399999999999977,562.756999067981383,3002.000000000000000,5,0,1,20.0000000,0,1,20.0000000,380,1534
310,4.000000000000000,0.000277777777778,187,2201,2014,769.750000000000000,833.827732508340091,3079.000000000000000,4,187,1,25.0000000,187,1,25.0000000,217,2201
311,3.000000000000000,0.000208333333333,504,1837,1333,1074.333333333333258,560.931566434108163,3223.000000000000000,3,504,1,33.3333015,504,1,33.3333015,882,1837
312,4.000000000000000,0.000277777777778,339,2032,1693,1151.500000000000000,604.509925476827902,4606.000000000000000,4,339,1,25.0000000,339,1,25.0000000,1008,2032
313,4.000000000000000,0.000277777777778,604,3518,2914,1419.500000000000000,1215.280728885305734,5678.000000000000000,4,604,1,25.0000000,604,1,25.0000000,689,3518
314,4.000000000000000,0.000277777777778,517,982,465,688.000000000000000,178.847700572302585,2752.000000000000000,4,517,1,25.0000000,517,1,25.0000000,578,982
315,4.000000000000000,0.000277777777778,530,2951,2421,1326.750000000000000,956.296077321244638,5307.000000000000000,4,530,1,25.0000000,530,1,25.0000000,767,2951
316,3.000000000000000,0.000208333333333,608,2569,1961,1607.000000000000000,801.002288802389558,4821.000000000000000,3,608,1,33.3333015,608,1,33.3333015,1644,2569
317,4.000000000000000,0.000277777777778,292,797,505,549.000000000000000,187.886934085369546,2196.000000000000000,4,292,1,25.0000000,292,1,25.0000000,471,797
318,4.000000000000000,0.000277777777778,392,510,118,458.500000000000000,43.095823463532980,1834.000000000000000,4,392,1,25.0000000,392,1,25.0000000,455,510
319,4.000000000000000,0.000277777777778,19,2460,2441,1150.750000000000000,912.297751559215499,4603.000000000000000,4,19,1,25.0000000,19,1,25.0000000,663,2460
320,3.000000000000000,0.000208333333333,522,909,387,748.000000000000000,164.541788005357461,2244.000000000000000,3,522,1,33.3333015,522,1,33.3333015,813,909
321,4.000000000000000,0.000277777777778,192,909,717,570.250000000000000,258.772462793087755,2281.000000000000000,4,192,1,25.0000000,192,1,25.0000000,522,909
322,4.000000000000000,0.000277777777778,290,1454,1164,757.500000000000000,441.896198218540917,3030.000000000000000,4,290,1,25.0000000,290,1,25.0000000,483,1454
323,3.000000000000000,0.000208333333333,174,1299,1125,813.333333333333371,471.957860642475396,2440.000000000000000,3,174,1,33.3333015,174,1,33.3333015,967,1299
324,4.000000000000000,0.000277777777778,371,5849,5478,1842.000000000000000,2315.517760674704732,7368.000000000000000,4,371,1,25.0000000,371,1,25.0000000,500,5849
325,5.000000000000000,0.000347222222222,451,2582,2131,1203.599999999999909,772.189251414444357,6018.000000000000000,5,451,1,20.0000000,451,1,20.0000000,1234,2582
326,4.000000000000000,0.000277777777778,24,46,22,36.000000000000000,9.669539802906858,144.000000000000000,4,24,1,25.0000000,24,1,25.0000000,29,46
327,4.000000000000000,0.000277777777778,1187,9368,8181,4162.750000000000000,3337.927978177480327,16651.000000000000000,4,1187,1,25.0000000,1187,1,25.0000000,1297,9368
328,4.000000000000000,0.000277777777778,64,1197,1133,600.500000000000000,404.523485103151927,2402.000000000000000,4,64,1,25.0000000,64,1,25.0000000,503,1197
329,4.000000000000000,0.000277777777778,64,1197,1133,600.500000000000000,404.523485103151927,2402.000000000000000,4,64,1,25.0000000,64,1,25.0000000,503,1197
330,5.000000000000000,0.000347222222222,1174,2335,1161,1665.000000000000000,442.399367088154861,8325.000000000000000,5,1174,1,20.0000000,1174,1,20.0000000,1812,2335
331,3.000000000000000,0.000208333333333,317,1379,1062,722.333333333333371,468.570402631474622,2167.000000000000000,3,317,1,33.3333015,317,1,33.3333015,471,1379
332,4.000000000000000,0.000277777777778,451,1509,1058,886.500000000000000,398.073799690459396,3546.000000000000000,4,451,1,25.0000000,451,1,25.0000000,653,1509
333,4.000000000000000,0.000277777777778,53,925,872,619.250000000000000,351.410283714065486,2477.000000000000000,4,53,1,25.0000000,53,1,25.0000000,598,925
334,4.000000000000000,0.000277777777778,2,246,244,119.250000000000014,116.489001626763041,477.000000000000000,4,2,1,25.0000000,2,1,25.0000000,4,246
335,4.000000000000000,0.000277777777778,2,246,244,119.250000000000014,116.489001626763041,477.000000000000000,4,2,1,25.0000000,2,1,25.0000000,4,246
336,4.000000000000000,0.000277777777778,2,246,244,119.250000000000014,116.489001626763041,477.000000000000000,4,2,1,25.0000000,2,1,25.0000000,4,246
337,4.000000000000000,0.000277777777778,30,292,262,102.000000000000000,110.009090533464558,408.000000000000000,4,30,1,25.0000000,30,1,25.0000000,34,292
338,4.000000000000000,0.000277777777778,209,1248,1039,550.000000000000000,419.181941404922668,2200.000000000000000,4,209,1,25.0000000,209,1,25.0000000,238,1248
339,4.000000000000000,0.000277777777778,209,1248,1039,550.000000000000000,419.181941404922668,2200.000000000000000,4,209,1,25.0000000,209,1,25.0000000,238,1248
340,4.000000000000000,0.000277777777778,25,626,601,399.750000000000000,240.547682383347848,1599.000000000000000,4,25,1,25.0000000,25,1,25.0000000,354,626
341,4.000000000000000,0.000277777777778,365,4339,3974,1486.250000000000000,1650.434090625857152,5945.000000000000000,4,365,1,25.0000000,365,1,25.0000000,595,4339
342,4.000000000000000,0.000277777777778,582,1981,1399,1097.500000000000000,572.679011314366221,4390.000000000000000,4,582,1,25.0000000,582,1,25.0000000,599,1981
343,4.000000000000000,0.000277777777778,763,1077,314,864.500000000000000,124.188364994471200,3458.000000000000000,4,763,1,25.0000000,763,1,25.0000000,803,1077
344,4.000000000000000,0.000277777777778,14,430,416,214.750000000000000,174.916229950225045,859.000000000000000,4,14,1,25.0000000,14,1,25.0000000,74,430
345,4.000000000000000,0.000277777777778,226,2428,2202,1066.500000000000000,849.712157144994649,4266.000000000000000,4,226,1,25.0000000,226,1,25.0000000,496,2428
346,4.000000000000000,0.000277777777778,0,496,496,213.000000000000000,182.013735745410173,852.000000000000000,4,0,1,25.0000000,0,1,25.0000000,130,496
347,4.000000000000000,0.000277777777778,120,929,809,542.250000000000000,308.884586051165741,2169.000000000000000,4,120,1,25.0000000,120,1,25.0000000,397,929
348,5.000000000000000,0.000347222222222,1228,2484,1256,1658.400000000000091,448.370204183997942,8292.000000000000000,5,1228,1,20.0000000,1228,1,20.0000000,1546,2484
349,4.000000000000000,0.000277777777778,0,218,218,75.500000000000000,87.810876319508395,302.000000000000000,4,0,1,25.0000000,0,1,25.0000000,6,218
350,4.000000000000000,0.000277777777778,85,966,881,601.500000000000000,330.339597989705112,2406.000000000000000,4,85,1,25.0000000,85,1,25.0000000,565,966
351,3.000000000000000,0.000208333333333,502,950,448,752.333333333333371,186.648213373596349,2257.000000000000000,3,502,1,33.3333015,502,1,33.3333015,805,950
352,4.000000000000000,0.000277777777778,237,598,361,433.500000000000000,139.818632520848240,1734.000000000000000,4,237,1,25.0000000,237,1,25.0000000,372,598
353,5.000000000000000,0.000347222222222,35,371,336,173.199999999999989,129.184209561385615,866.000000000000000,5,35,1,20.0000000,35,1,20.0000000,110,371
354,5.000000000000000,0.000347222222222,72,371,299,194.800000000000011,112.180925294811146,974.000000000000000,5,72,1,20.0000000,72,1,20.0000000,143,371
355,4.000000000000000,0.000277777777778,72,371,299,207.750000000000000,122.033550714547346,831.000000000000000,4,72,1,25.0000000,72,1,25.0000000,110,371
356,4.000000000000000,0.000277777777778,240,1228,988,563.250000000000000,389.863678097870491,2253.000000000000000,4,240,1,25.0000000,240,1,25.0000000,352,1228
357,5.000000000000000,0.000347222222222,105,909,804,522.399999999999977,302.612359298162175,2612.000000000000000,5,105,1,20.0000000,105,1,20.0000000,545,909
358,4.000000000000000,0.000277777777778,272,833,561,561.000000000000000,198.540927770573290,2244.000000000000000,4,272,1,25.0000000,272,1,25.0000000,566,833
359,5.000000000000000,0.000347222222222,5,3066,3061,769.600000000000023,1167.550016059269410,3848.000000000000000,5,5,1,20.0000000,5,1,20.0000000,130,3066
360,3.000000000000000,0.000208333333333,388,1873,1485,1133.000000000000000,606.259020551447179,3399.000000000000000,3,388,1,33.3333015,388,1,33.3333015,1138,1873
361,4.000000000000000,0.000277777777778,912,5463,4551,2601.500000000000000,1877.725019804550584,10406.000000000000000,4,912,1,25.0000000,912,1,25.0000000,926,5463
362,5.000000000000000,0.000347222222222,2603,8118,5515,5267.000000000000000,1984.797319627371962,26335.000000000000000,5,2603,1,20.0000000,2603,1,20.0000000,4882,8118
363,4.000000000000000,0.000277777777778,1101,6833,5732,3609.000000000000000,2108.339156777201424,14436.000000000000000,4,1101,1,25.0000000,1101,1,25.0000000,2603,6833
364,3.000000000000000,0.000208333333333,749,1563,814,1255.333333333333258,360.786486566347037,3766.000000000000000,3,749,1,33.3333015,749,1,33.3333015,1454,1563
365,4.000000000000000,0.000277777777778,1474,4216,2742,2265.750000000000000,1129.924416719985857,9063.000000000000000,4,1474,1,25.0000000,1474,1,25.0000000,1634,4216
366,4.000000000000000,0.000277777777778,73,1592,1519,618.500000000000000,585.885014315949206,2474.000000000000000,4,73,1,25.0000000,73,1,25.0000000,270,1592
367,4.000000000000000,0.000277777777778,55,572,517,233.000000000000000,208.474219029596071,932.000000000000000,4,55,1,25.0000000,55,1,25.0000000,68,572
368,4.000000000000000,0.000277777777778,35,923,888,578.250000000000000,370.268399272743750,2313.000000000000000,4,35,1,25.0000000,35,1,25.0000000,438,923
369,4.000000000000000,0.000277777777778,475,907,432,678.750000000000000,171.997638065178108,2715.000000000000000,4,475,1,25.0000000,475,1,25.0000000,556,907
370,4.000000000000000,0.000277777777778,161,3824,3663,1753.250000000000000,1435.291324958107680,7013.000000000000000,4,161,1,25.0000000,161,1,25.0000000,707,3824
371,4.000000000000000,0.000277777777778,46,170,124,109.250000000000000,48.266836440769559,437.000000000000000,4,46,1,25.0000000,46,1,25.0000000,82,170
372,4.000000000000000,0.000277777777778,46,170,124,109.250000000000000,48.266836440769559,437.000000000000000,4,46,1,25.0000000,46,1,25.0000000,82,170
373,4.000000000000000,0.000277777777778,93,7544,7451,2448.500000000000000,2973.399779713451608,9794.000000000000000,4,93,1,25.0000000,93,1,25.0000000,857,7544
374,4.000000000000000,0.000277777777778,158,868,710,404.000000000000000,274.600619081603668,1616.000000000000000,4,158,1,25.0000000,158,1,25.0000000,263,868
375,3.000000000000000,0.000208333333333,130,622,492,310.000000000000000,221.485891198514054,930.000000000000000,3,130,1,33.3333015,130,1,33.3333015,178,622
376,4.000000000000000,0.000277777777778,131,1822,1691,902.500000000000000,637.398031060655171,3610.000000000000000,4,131,1,25.0000000,131,1,25.0000000,534,1822
377,4.000000000000000,0.000277777777778,136,2384,2248,897.250000000000000,916.040767378832356,3589.000000000000000,4,136,1,25.0000000,136,1,25.0000000,145,2384
378,5.000000000000000,0.000347222222222,58,1029,971,462.800000000000011,379.955997452336590,2314.000000000000000,5,58,1,20.0000000,58,1,20.0000000,421,1029
379,4.000000000000000,0.000277777777778,124,742,618,496.250000000000000,227.488873354280770,1985.000000000000000,4,124,1,25.0000000,124,1,25.0000000,555,742
380,3.000000000000000,0.000208333333333,43,1698,1655,840.000000000000000,677.026341191143501,2520.000000000000000,3,43,1,33.3333015,43,1,33.3333015,779,1698
381,3.000000000000000,0.000208333333333,843,1911,1068,1475.666666666666742,457.792772138466830,4427.000000000000000,3,843,1,33.3333015,843,1,33.3333015,1673,1911
382,4.000000000000000,0.000277777777778,322,829,507,501.750000000000000,193.835465021239088,2007.000000000000000,4,322,1,25.0000000,322,1,25.0000000,426,829
383,4.000000000000000,0.000277777777778,359,4860,4501,2509.750000000000000,1997.680451799035836,10039.000000000000000,4,359,1,25.0000000,359,1,25.0000000,708,4860
384,3.000000000000000,0.000208333333333,359,4860,4501,3110.333333333333485,1969.306533331523269,9331.000000000000000,3,359,1,33.3333015,359,1,33.3333015,4112,4860
385,4.000000000000000,0.000277777777778,359,4860,4501,2509.750000000000000,1997.680451799035836,10039.000000000000000,4,359,1,25.0000000,359,1,25.0000000,708,4860
386,4.000000000000000,0.000277777777778,807,1168,361,984.250000000000000,170.121096575351288,3937.000000000000000,4,807,1,25.0000000,807,1,25.0000000,822,1168
387,4.000000000000000,0.000277777777778,242,3678,3436,1663.250000000000000,1402.346493381717664,6653.000000000000000,4,242,1,25.0000000,242,1,25.0000000,469,3678
388,3.000000000000000,0.000208333333333,335,661,326,542.000000000000000,146.917210246678280,1626.000000000000000,3,335,1,33.3333015,335,1,33.3333015,630,661
389,4.000000000000000,0.000277777777778,507,2995,2488,1229.750000000000000,1024.756403980965615,4919.000000000000000,4,507,1,25.0000000,507,1,25.0000000,612,2995
390,4.000000000000000,0.000277777777778,26,396,370,242.000000000000000,138.316665662529630,968.000000000000000,4,26,1,25.0000000,26,1,25.0000000,227,396
391,4.000000000000000,0.000277777777778,10,239,229,70.500000000000000,97.397381894997565,282.000000000000000,4,10,1,25.0000000,10,1,25.0000000,11,239
392,4.000000000000000,0.000277777777778,398,2203,1805,1235.000000000000000,641.903030059836965,4940.000000000000000,4,398,1,25.0000000,398,1,25.0000000,1138,2203
393,3.000000000000000,0.000208333333333,21,1041,1020,413.000000000000000,448.606732004770549,1239.000000000000000,3,21,1,33.3333015,21,1,33.3333015,177,1041
394,5.000000000000000,0.000347222222222,9,161,152,52.600000000000001,54.942151395809034,263.000000000000000,5,9,1,20.0000000,9,1,20.0000000,30,161
395,5.000000000000000,0.000347222222222,524,1837,1313,1203.799999999999955,587.060269478356076,6019.000000000000000,5,524,1,20.0000000,524,1,20.0000000,1303,1837
396,4.000000000000000,0.000277777777778,2,59,57,18.500000000000000,23.584952830141511,74.000000000000000,4,2,1,25.0000000,2,1,25.0000000,3,59
397,4.000000000000000,0.000277777777778,53,7410,7357,2200.250000000000000,3044.670784748328060,8801.000000000000000,4,53,1,25.0000000,53,1,25.0000000,104,7410
398,4.000000000000000,0.000277777777778,521,1920,1399,1084.500000000000000,566.972001072363355,4338.000000000000000,4,521,1,25.0000000,521,1,25.0000000,607,1920
399,4.000000000000000,0.000277777777778,607,1290,683,961.500000000000000,247.348438442614793,3846.000000000000000,4,607,1,25.0000000,607,1,25.0000000,901,1290
400,4.000000000000000,0.000277777777778,180,788,608,446.500000000000000,227.297712263014205,1786.000000000000000,4,180,1,25.0000000,180,1,25.0000000,319,788
401,3.000000000000000,0.000208333333333,427,1745,1318,872.000000000000000,617.343232462028936,2616.000000000000000,3,427,1,33.3333015,427,1,33.3333015,444,1745
402,4.000000000000000,0.000277777777778,209,706,497,463.000000000000000,198.548482744139847,1852.000000000000000,4,209,1,25.0000000,209,1,25.0000000,338,706
403,4.000000000000000,0.000277777777778,745,864,119,789.250000000000000,46.724592026041257,3157.000000000000000,4,745,1,25.0000000,745,1,25.0000000,755,864
404,4.000000000000000,0.000277777777778,468,2734,2266,1773.000000000000000,829.561932588519994,7092.000000000000000,4,468,1,25.0000000,468,1,25.0000000,1762,2734
405,4.000000000000000,0.000277777777778,215,853,638,627.000000000000000,244.110630657495136,2508.000000000000000,4,215,1,25.0000000,215,1,25.0000000,709,853
406,4.000000000000000,0.000277777777778,374,2856,2482,1372.750000000000000,910.689676838383889,5491.000000000000000,4,374,1,25.0000000,374,1,25.0000000,1095,2856
407,4.000000000000000,0.000277777777778,327,995,668,563.000000000000000,256.129849880875838,2252.000000000000000,4,327,1,25.0000000,327,1,25.0000000,444,995
408,4.000000000000000,0.000277777777778,0,464,464,126.750000000000000,195.501118922629189,507.000000000000000,3,0,2,50.0000000,43,1,25.0000000,0,464
409,4.000000000000000,0.000277777777778,4,174,170,73.500000000000000,71.086215260062900,294.000000000000000,4,4,1,25.0000000,4,1,25.0000000,9,174
410,4.000000000000000,0.000277777777778,578,1610,1032,956.250000000000000,390.328307326025254,3825.000000000000000,4,578,1,25.0000000,578,1,25.0000000,796,1610
411,4.000000000000000,0.000277777777778,20,3168,3148,1935.750000000000000,1243.953852640844616,7743.000000000000000,4,20,1,25.0000000,20,1,25.0000000,1658,3168
412,4.000000000000000,0.000277777777778,0,219,219,54.750000000000000,94.829781714396034,219.000000000000000,2,0,3,75.0000000,219,1,25.0000000,0,219
413,4.000000000000000,0.000277777777778,366,1632,1266,948.750000000000000,486.353459430484577,3795.000000000000000,4,366,1,25.0000000,366,1,25.0000000,639,1632
414,4.000000000000000,0.000277777777778,366,1632,1266,948.750000000000000,486.353459430484577,3795.000000000000000,4,366,1,25.0000000,366,1,25.0000000,639,1632
415,3.000000000000000,0.000208333333333,1985,3667,1682,2959.000000000000000,711.968164082261978,8877.000000000000000,3,1985,1,33.3333015,1985,1,33.3333015,3225,3667
416,4.000000000000000,0.000277777777778,501,2673,2172,1334.000000000000000,881.595995907422434,5336.000000000000000,4,501,1,25.0000000,501,1,25.0000000,584,2673
417,4.000000000000000,0.000277777777778,13,1209,1196,467.750000000000000,488.818665253281836,1871.000000000000000,4,13,1,25.0000000,13,1,25.0000000,43,1209
418,4.000000000000000,0.000277777777778,26,658,632,261.250000000000000,251.234327869421548,1045.000000000000000,4,26,1,25.0000000,26,1,25.0000000,65,658
419,4.000000000000000,0.000277777777778,0,174,174,80.750000000000000,81.232305765625043,323.000000000000000,3,0,2,50.0000000,149,1,25.0000000,0,174
420,4.000000000000000,0.000277777777778,693,2749,2056,1503.500000000000000,776.579841355671533,6014.000000000000000,4,693,1,25.0000000,693,1,25.0000000,1052,2749
421,4.000000000000000,0.000277777777778,748,3591,2843,1807.000000000000000,1169.845502619897161,7228.000000000000000,4,748,1,25.0000000,748,1,25.0000000,771,3591
422,4.000000000000000,0.000277777777778,670,2834,2164,1619.750000000000000,911.593213829502020,6479.000000000000000,4,670,1,25.0000000,670,1,25.0000000,812,2834
423,4.000000000000000,0.000277777777778,29,2787,2758,1574.500000000000000,1210.630930548199785,6298.000000000000000,4,29,1,25.0000000,29,1,25.0000000,754,2787
424,4.000000000000000,0.000277777777778,66,4213,4147,1203.750000000000000,1740.590040043892714,4815.000000000000000,4,66,1,25.0000000,66,1,25.0000000,175,4213
425,4.000000000000000,0.000277777777778,66,4213,4147,1203.750000000000000,1740.590040043892714,4815.000000000000000,4,66,1,25.0000000,66,1,25.0000000,175,4213
426,4.000000000000000,0.000277777777778,1105,2194,1089,1775.250000000000000,405.790201335616302,7101.000000000000000,4,1105,1,25.0000000,1105,1,25.0000000,1866,2194
427,4.000000000000000,0.000277777777778,406,757,351,630.250000000000000,133.421090911444736,2521.000000000000000,4,406,1,25.0000000,406,1,25.0000000,672,757
428,4.000000000000000,0.000277777777778,233,606,373,378.500000000000000,138.105937598642015,1514.000000000000000,4,233,1,25.0000000,233,1,25.0000000,336,606
429,4.000000000000000,0.000277777777778,526,936,410,762.750000000000000,148.615905945494262,3051.000000000000000,4,526,1,25.0000000,526,1,25.0000000,783,936
430,3.000000000000000,0.000208333333333,526,936,410,756.000000000000000,171.075032271417882,2268.000000000000000,3,526,1,33.3333015,526,1,33.3333015,806,936
431,4.000000000000000,0.000277777777778,2323,25968,23645,13786.750000000000000,8437.568796015828411,55147.000000000000000,4,2323,1,25.0000000,2323,1,25.0000000,11893,25968
432,4.000000000000000,0.000277777777778,805,3556,2751,2321.500000000000000,1118.602364560347269,9286.000000000000000,4,805,1,25.0000000,805,1,25.0000000,1707,3556
433,5.000000000000000,0.000347222222222,371,1487,1116,783.000000000000000,406.575946165043092,3915.000000000000000,5,371,1,20.0000000,371,1,20.0000000,815,1487
434,4.000000000000000,0.000277777777778,895,3183,2288,1762.000000000000000,857.902966541088517,7048.000000000000000,4,895,1,25.0000000,895,1,25.0000000,1386,3183
435,4.000000000000000,0.000277777777778,209,894,685,615.500000000000000,277.694526413467486,2462.000000000000000,4,209,1,25.0000000,209,1,25.0000000,510,894
436,4.000000000000000,0.000277777777778,296,1037,741,691.500000000000000,270.675543778894053,2766.000000000000000,4,296,1,25.0000000,296,1,25.0000000,627,1037
437,4.000000000000000,0.000277777777778,1187,9368,8181,4162.750000000000000,3337.927978177480327,16651.000000000000000,4,1187,1,25.0000000,1187,1,25.0000000,1297,9368
438,4.000000000000000,0.000277777777778,9,402,393,142.250000000000000,154.658292697158657,569.000000000000000,4,9,1,25.0000000,9,1,25.0000000,44,402
439,4.000000000000000,0.000277777777778,1159,2502,1343,1776.500000000000000,481.871611531536473,7106.000000000000000,4,1159,1,25.0000000,1159,1,25.0000000,1635,2502
440,4.000000000000000,0.000277777777778,1159,2502,1343,1776.500000000000000,481.871611531536473,7106.000000000000000,4,1159,1,25.0000000,1159,1,25.0000000,1635,2502
441,4.000000000000000,0.000277777777778,135,1403,1268,487.500000000000000,530.271864235695602,1950.000000000000000,4,135,1,25.0000000,135,1,25.0000000,162,1403
442,4.000000000000000,0.000277777777778,474,3276,2802,1576.750000000000000,1088.501119659506912,6307.000000000000000,4,474,1,25.0000000,474,1,25.0000000,800,3276
443,4.000000000000000,0.000277777777778,133,909,776,594.250000000000000,302.030937984836271,2377.000000000000000,4,133,1,25.0000000,133,1,25.0000000,522,909
444,4.000000000000000,0.000277777777778,223,1483,1260,724.750000000000000,512.633580152529589,2899.000000000000000,4,223,1,25.0000000,223,1,25.0000000,287,1483
445,4.000000000000000,0.000277777777778,211,2490,2279,1596.250000000000000,926.356134270184498,6385.000000000000000,4,211,1,25.0000000,211,1,25.0000000,1297,2490
446,3.000000000000000,0.000208333333333,211,2478,2267,1692.000000000000000,1047.883899421432488,5076.000000000000000,3,211,1,33.3333015,211,1,33.3333015,2387,2478
447,4.000000000000000,0.000277777777778,211,2478,2267,1443.750000000000000,1004.205998538148492,5775.000000000000000,4,211,1,25.0000000,211,1,25.0000000,699,2478
448,4.000000000000000,0.000277777777778,449,1309,860,770.250000000000000,327.654829813326558,3081.000000000000000,4,449,1,25.0000000,449,1,25.0000000,583,1309
449,4.000000000000000,0.000277777777778,543,1025,482,789.500000000000000,199.687881455034727,3158.000000000000000,4,543,1,25.0000000,543,1,25.0000000,648,1025
450,5.000000000000000,0.000347222222222,68,2846,2778,680.000000000000000,1084.589692003386062,3400.000000000000000,5,68,1,20.0000000,68,1,20.0000000,201,2846
451,4.000000000000000,0.000277777777778,1166,2319,1153,1796.000000000000000,429.056523082915021,7184.000000000000000,4,1166,1,25.0000000,1166,1,25.0000000,1676,2319
452,4.000000000000000,0.000277777777778,1676,2319,643,2085.750000000000000,243.987064206281303,8343.000000000000000,4,1676,1,25.0000000,1676,1,25.0000000,2163,2319
453,4.000000000000000,0.000277777777778,211,2561,2350,1385.250000000000000,1133.057009819011682,5541.000000000000000,4,211,1,25.0000000,211,1,25.0000000,295,2561
454,4.000000000000000,0.000277777777778,789,1750,961,1277.750000000000000,378.002893507443957,5111.000000000000000,4,789,1,25.0000000,789,1,25.0000000,1052,1750
455,4.000000000000000,0.000277777777778,573,727,154,630.750000000000000,63.845027214341449,2523.000000000000000,3,573,2,50.0000000,650,1,25.0000000,573,727
456,4.000000000000000,0.000277777777778,215,2318,2103,857.750000000000000,849.639445588539047,3431.000000000000000,4,215,1,25.0000000,215,1,25.0000000,386,2318
457,3.000000000000000,0.000208333333333,386,2318,1932,1072.000000000000000,882.555380698571184,3216.000000000000000,3,386,1,33.3333015,386,1,33.3333015,512,2318
458,4.000000000000000,0.000277777777778,215,2318,2103,857.750000000000000,849.639445588539047,3431.000000000000000,4,215,1,25.0000000,215,1,25.0000000,386,2318
459,3.000000000000000,0.000208333333333,26,706,680,296.333333333333371,294.573514687854356,889.000000000000000,3,26,1,33.3333015,26,1,33.3333015,157,706
460,4.000000000000000,0.000277777777778,895,1540,645,1159.500000000000000,248.612650522856569,4638.000000000000000,4,895,1,25.0000000,895,1,25.0000000,988,1540
461,4.000000000000000,0.000277777777778,522,3761,3239,1462.500000000000000,1334.281173516287026,5850.000000000000000,4,522,1,25.0000000,522,1,25.0000000,658,3761
462,3.000000000000000,0.000208333333333,522,909,387,748.000000000000000,164.541788005357461,2244.000000000000000,3,522,1,33.3333015,522,1,33.3333015,813,909
463,4.000000000000000,0.000277777777778,19,1467,1448,734.500000000000000,523.320886263867692,2938.000000000000000,4,19,1,25.0000000,19,1,25.0000000,573,1467
464,4.000000000000000,0.000277777777778,43,131,88,90.500000000000000,40.801348016946697,362.000000000000000,3,131,2,50.0000000,43,1,25.0000000,57,131
465,4.000000000000000,0.000277777777778,28,4880,4852,1483.000000000000000,1996.032815361510984,5932.000000000000000,4,28,1,25.0000000,28,1,25.0000000,68,4880
466,5.000000000000000,0.000347222222222,2,95,93,41.600000000000001,35.589886203807957,208.000000000000000,4,2,2,40.0000000,52,1,20.0000000,52,95
467,4.000000000000000,0.000277777777778,753,8479,7726,3982.749999999999545,2840.111122385882936,15931.000000000000000,4,753,1,25.0000000,753,1,25.0000000,2711,8479
468,4.000000000000000,0.000277777777778,637,1412,775,1051.250000000000000,312.130882003046906,4205.000000000000000,4,637,1,25.0000000,637,1,25.0000000,870,1412
469,4.000000000000000,0.000277777777778,433,5987,5554,2941.500000000000000,2124.966999743760880,11766.000000000000000,4,433,1,25.0000000,433,1,25.0000000,1589,5987
470,4.000000000000000,0.000277777777778,68,794,726,352.000000000000000,270.199000738344694,1408.000000000000000,4,68,1,25.0000000,68,1,25.0000000,231,794
471,4.000000000000000,0.000277777777778,89,665,576,433.000000000000000,238.277149554882840,1732.000000000000000,4,89,1,25.0000000,89,1,25.0000000,333,665
472,4.000000000000000,0.000277777777778,91,906,815,582.000000000000000,315.145204627961903,2328.000000000000000,4,91,1,25.0000000,91,1,25.0000000,529,906
473,4.000000000000000,0.000277777777778,316,830,514,542.000000000000000,187.579316557023418,2168.000000000000000,4,316,1,25.0000000,316,1,25.0000000,462,830
474,4.000000000000000,0.000277777777778,274,1017,743,625.750000000000000,310.709973286986724,2503.000000000000000,4,274,1,25.0000000,274,1,25.0000000,373,1017
475,4.000000000000000,0.000277777777778,369,1091,722,610.250000000000000,285.080142240739008,2441.000000000000000,4,369,1,25.0000000,369,1,25.0000000,431,1091
476,4.000000000000000,0.000277777777778,15,804,789,273.500000000000000,320.906917968435209,1094.000000000000000,4,15,1,25.0000000,15,1,25.0000000,22,804
477,4.000000000000000,0.000277777777778,417,7933,7516,2674.000000000000000,3093.524769579193162,10696.000000000000000,4,417,1,25.0000000,417,1,25.0000000,458,7933
478,4.000000000000000,0.000277777777778,392,732,340,547.750000000000000,124.896707322491096,2191.000000000000000,4,392,1,25.0000000,392,1,25.0000000,490,732
479,5.000000000000000,0.000347222222222,446,1268,822,765.800000000000068,274.867531731195925,3829.000000000000000,5,446,1,20.0000000,446,1,20.0000000,737,1268
480,4.000000000000000,0.000277777777778,72,1037,965,505.250000000000000,362.806680616550921,2021.000000000000000,4,72,1,25.0000000,72,1,25.0000000,296,1037
481,4.000000000000000,0.000277777777778,1813,8607,6794,4164.750000000000000,2693.400673405276848,16659.000000000000000,4,1813,1,25.0000000,1813,1,25.0000000,2234,8607
482,4.000000000000000,0.000277777777778,941,2754,1813,1490.000000000000000,743.106654525445720,5960.000000000000000,4,941,1,25.0000000,941,1,25.0000000,968,2754
483,4.000000000000000,0.000277777777778,430,5305,4875,2094.750000000000000,1987.406271374828748,8379.000000000000000,4,430,1,25.0000000,430,1,25.0000000,448,5305
484,4.000000000000000,0.000277777777778,917,1523,606,1074.500000000000000,259.003378356345024,4298.000000000000000,4,917,1,25.0000000,917,1,25.0000000,925,1523
485,3.000000000000000,0.000208333333333,462,2664,2202,1344.000000000000000,950.818594685653011,4032.000000000000000,3,462,1,33.3333015,462,1,33.3333015,906,2664
486,4.000000000000000,0.000277777777778,67,916,849,356.500000000000000,333.317041268519631,1426.000000000000000,4,67,1,25.0000000,67,1,25.0000000,147,916
487,5.000000000000000,0.000347222222222,163,2623,2460,843.400000000000091,908.775571854789632,4217.000000000000000,5,163,1,20.0000000,163,1,20.0000000,585,2623
488,4.000000000000000,0.000277777777778,12,180,168,93.250000000000000,68.291196357949389,373.000000000000000,4,12,1,25.0000000,12,1,25.0000000,43,180
489,4.000000000000000,0.000277777777778,19,269,250,136.500000000000000,90.184533041980103,546.000000000000000,4,19,1,25.0000000,19,1,25.0000000,106,269
490,4.000000000000000,0.000277777777778,72,1458,1386,755.750000000000000,568.899101335201635,3023.000000000000000,4,72,1,25.0000000,72,1,25.0000000,338,1458
491,4.000000000000000,0.000277777777778,72,1458,1386,755.750000000000000,568.899101335201635,3023.000000000000000,4,72,1,25.0000000,72,1,25.0000000,338,1458
492,4.000000000000000,0.000277777777778,397,3061,2664,1117.000000000000000,1123.507231841433168,4468.000000000000000,4,397,1,25.0000000,397,1,25.0000000,470,3061
493,4.000000000000000,0.000277777777778,731,1326,595,1027.250000000000000,210.367981166336250,4109.000000000000000,3,1026,2,50.0000000,731,1,25.0000000,1026,1326
494,4.000000000000000,0.000277777777778,28,2283,2255,1019.250000000000000,925.784363391389320,4077.000000000000000,4,28,1,25.0000000,28,1,25.0000000,246,2283
495,5.000000000000000,0.000347222222222,456,857,401,624.200000000000045,143.406276013290324,3121.000000000000000,5,456,1,20.0000000,456,1,20.0000000,612,857
496,4.000000000000000,0.000277777777778,349,1745,1396,1124.000000000000000,501.576514601710585,4496.000000000000000,4,349,1,25.0000000,349,1,25.0000000,1137,1745
497,4.000000000000000,0.000277777777778,82,727,645,542.500000000000000,266.565657953157938,2170.000000000000000,4,82,1,25.0000000,82,1,25.0000000,676,727
498,3.000000000000000,0.000208333333333,43,1698,1655,670.333333333333258,732.555496570434343,2011.000000000000000,3,43,1,33.3333015,43,1,33.3333015,270,1698
499,4.000000000000000,0.000277777777778,132,3636,3504,1153.750000000000000,1442.044793860440450,4615.000000000000000,4,132,1,25.0000000,132,1,25.0000000,272,3636
500,4.000000000000000,0.000277777777778,58,1029,971,434.000000000000000,366.744461444205058,1736.000000000000000,4,58,1,25.0000000,58,1,25.0000000,228,1029
501,4.000000000000000,0.000277777777778,2945,16457,13512,10170.500000000000000,4817.898167250943516,40682.000000000000000,4,2945,1,25.0000000,2945,1,25.0000000,10057,16457
502,4.000000000000000,0.000277777777778,2,43,41,26.250000000000000,16.558608033285889,105.000000000000000,4,2,1,25.0000000,2,1,25.0000000,20,43
503,4.000000000000000,0.000277777777778,9,296,287,115.750000000000000,108.372909437737249,463.000000000000000,4,9,1,25.0000000,9,1,25.0000000,65,296
504,4.000000000000000,0.000277777777778,34,669,635,317.000000000000000,245.706125279774000,1268.000000000000000,4,34,1,25.0000000,34,1,25.0000000,150,669
505,5.000000000000000,0.000347222222222,133,1227,1094,703.799999999999955,440.319611191688807,3519.000000000000000,5,133,1,20.0000000,133,1,20.0000000,730,1227
506,3.000000000000000,0.000208333333333,689,1911,1222,1190.666666666666515,522.291319305827869,3572.000000000000000,3,689,1,33.3333015,689,1,33.3333015,972,1911
507,3.000000000000000,0.000208333333333,543,1699,1156,964.333333333333371,521.355498250047731,2893.000000000000000,3,543,1,33.3333015,543,1,33.3333015,651,1699
508,4.000000000000000,0.000277777777778,65,319,254,138.000000000000000,105.558040906413197,552.000000000000000,4,65,1,25.0000000,65,1,25.0000000,66,319
509,4.000000000000000,0.000277777777778,1,8,7,3.250000000000000,2.772634126602354,13.000000000000000,3,2,2,50.0000000,1,1,25.0000000,2,8
510,4.000000000000000,0.000277777777778,911,1430,519,1154.500000000000000,207.620446969945618,4618.000000000000000,4,911,1,25.0000000,911,1,25.0000000,1003,1430
511,3.000000000000000,0.000208333333333,349,1465,1116,1085.333333333333258,520.750953485018158,3256.000000000000000,3,349,1,33.3333015,349,1,33.3333015,1442,1465
512,4.000000000000000,0.000277777777778,263,1697,1434,1061.000000000000000,555.522726807823801,4244.000000000000000,4,263,1,25.0000000,263,1,25.0000000,842,1697
513,4.000000000000000,0.000277777777778,465,913,448,668.000000000000000,170.216039197250780,2672.000000000000000,4,465,1,25.0000000,465,1,25.0000000,564,913
514,4.000000000000000,0.000277777777778,0,5975,5975,3533.500000000000000,2232.818678262970934,14134.000000000000000,4,0,1,25.0000000,0,1,25.0000000,3409,5975
515,4.000000000000000,0.000277777777778,953,2656,1703,1673.250000000000000,669.203397705062571,6693.000000000000000,4,953,1,25.0000000,953,1,25.0000000,1173,2656
516,3.000000000000000,0.000208333333333,571,1056,485,790.333333333333371,200.692689342575619,2371.000000000000000,3,571,1,33.3333015,571,1,33.3333015,744,1056
517,4.000000000000000,0.000277777777778,224,1201,977,788.250000000000000,353.972015136790162,3153.000000000000000,4,224,1,25.0000000,224,1,25.0000000,842,1201
518,4.000000000000000,0.000277777777778,55,124,69,82.750000000000000,28.656369274560934,331.000000000000000,4,55,1,25.0000000,55,1,25.0000000,57,124
519,4.000000000000000,0.000277777777778,186,2678,2492,1466.750000000000000,1119.493495961454983,5867.000000000000000,4,186,1,25.0000000,186,1,25.0000000,526,2678
520,4.000000000000000,0.000277777777778,142,1013,871,526.500000000000000,331.175557672965965,2106.000000000000000,4,142,1,25.0000000,142,1,25.0000000,319,1013
521,4.000000000000000,0.000277777777778,636,2372,1736,1198.000000000000000,696.519920748861296,4792.000000000000000,4,636,1,25.0000000,636,1,25.0000000,720,2372
522,4.000000000000000,0.000277777777778,636,2372,1736,1198.000000000000000,696.519920748861296,4792.000000000000000,4,636,1,25.0000000,636,1,25.0000000,720,2372
523,3.000000000000000,0.000208333333333,449,659,210,535.000000000000000,89.844309780864805,1605.000000000000000,3,449,1,33.3333015,449,1,33.3333015,497,659
524,4.000000000000000,0.000277777777778,316,830,514,542.000000000000000,187.579316557023418,2168.000000000000000,4,316,1,25.0000000,316,1,25.0000000,462,830
525,4.000000000000000,0.000277777777778,31,128,97,55.250000000000000,42.002232083545273,221.000000000000000,2,31,3,75.0000000,128,1,25.0000000,31,128
526,4.000000000000000,0.000277777777778,58,1013,955,608.000000000000000,347.038182337333012,2432.000000000000000,4,58,1,25.0000000,58,1,25.0000000,632,1013
527,4.000000000000000,0.000277777777778,158,944,786,507.750000000000000,282.552981757404211,2031.000000000000000,4,158,1,25.0000000,158,1,25.0000000,426,944
528,5.000000000000000,0.000347222222222,26,249,223,106.400000000000006,79.866388424668358,532.000000000000000,5,26,1,20.0000000,26,1,20.0000000,62,249
529,4.000000000000000,0.000277777777778,618,5267,4649,2843.500000000000000,1668.370837074299970,11374.000000000000000,4,618,1,25.0000000,618,1,25.0000000,2365,5267
530,4.000000000000000,0.000277777777778,143,1464,1321,835.500000000000000,609.739493554419482,3342.000000000000000,4,143,1,25.0000000,143,1,25.0000000,315,1464
531,4.000000000000000,0.000277777777778,93,1353,1260,506.250000000000000,507.928821292905184,2025.000000000000000,4,93,1,25.0000000,93,1,25.0000000,131,1353
532,3.000000000000000,0.000208333333333,1274,1974,700,1662.666666666666742,290.958569024678980,4988.000000000000000,3,1274,1,33.3333015,1274,1,33.3333015,1740,1974
533,4.000000000000000,0.000277777777778,612,1470,858,1105.250000000000000,310.877286883426052,4421.000000000000000,4,612,1,25.0000000,612,1,25.0000000,1138,1470
534,4.000000000000000,0.000277777777778,470,2692,2222,1272.750000000000000,844.239117489825844,5091.000000000000000,4,470,1,25.0000000,470,1,25.0000000,931,2692
535,4.000000000000000,0.000277777777778,113,481,368,264.750000000000000,147.635319283699886,1059.000000000000000,4,113,1,25.0000000,113,1,25.0000000,145,481
536,4.000000000000000,0.000277777777778,618,1555,937,1088.000000000000000,338.671669910549213,4352.000000000000000,4,618,1,25.0000000,618,1,25.0000000,990,1555
537,4.000000000000000,0.000277777777778,303,1274,971,923.750000000000000,383.535770821966480,3695.000000000000000,4,303,1,25.0000000,303,1,25.0000000,911,1274
538,4.000000000000000,0.000277777777778,303,922,619,616.750000000000000,299.938639558160276,2467.000000000000000,4,303,1,25.0000000,303,1,25.0000000,331,922
539,4.000000000000000,0.000277777777778,615,1887,1272,1098.000000000000000,491.244847301221057,4392.000000000000000,4,615,1,25.0000000,615,1,25.0000000,768,1887
540,4.000000000000000,0.000277777777778,659,5779,5120,2131.750000000000000,2112.833095040874468,8527.000000000000000,4,659,1,25.0000000,659,1,25.0000000,943,5779
541,4.000000000000000,0.000277777777778,79,738,659,384.250000000000000,234.558494836575903,1537.000000000000000,4,79,1,25.0000000,79,1,25.0000000,343,738
542,3.000000000000000,0.000208333333333,343,677,334,465.666666666666629,150.078497978742973,1397.000000000000000,3,343,1,33.3333015,343,1,33.3333015,377,677
543,4.000000000000000,0.000277777777778,2,95,93,40.750000000000000,33.781466812440222,163.000000000000000,3,33,2,50.0000000,2,1,25.0000000,33,95
544,5.000000000000000,0.000347222222222,2408,73900,71492,49273.600000000005821,27494.122998197271954,246368.000000000000000,5,2408,1,20.0000000,2408,1,20.0000000,66568,73900
545,4.000000000000000,0.000277777777778,853,2835,1982,1360.250000000000000,851.547231514494456,5441.000000000000000,4,853,1,25.0000000,853,1,25.0000000,864,2835
546,4.000000000000000,0.000277777777778,1005,11012,10007,3809.000000000000000,4167.817954277753415,15236.000000000000000,4,1005,1,25.0000000,1005,1,25.0000000,1434,11012
547,3.000000000000000,0.000208333333333,35,1104,1069,394.000000000000000,502.056437730527136,1182.000000000000000,3,35,1,33.3333015,35,1,33.3333015,43,1104
548,5.000000000000000,0.000347222222222,359,478,119,420.800000000000011,38.399999999999999,2104.000000000000000,5,359,1,20.0000000,359,1,20.0000000,427,478
549,4.000000000000000,0.000277777777778,94,852,758,300.250000000000000,319.355894731880596,1201.000000000000000,4,94,1,25.0000000,94,1,25.0000000,102,852
550,4.000000000000000,0.000277777777778,6,57,51,29.749999999999996,23.424079490985338,119.000000000000000,4,6,1,25.0000000,6,1,25.0000000,7,57
551,5.000000000000000,0.000347222222222,31,570,539,164.600000000000023,205.227288633846172,823.000000000000000,5,31,1,20.0000000,31,1,20.0000000,52,570
552,5.000000000000000,0.000347222222222,16,415,399,133.199999999999989,151.359704016623937,666.000000000000000,5,16,1,20.0000000,16,1,20.0000000,51,415
553,4.000000000000000,0.000277777777778,807,1168,361,984.250000000000000,170.121096575351288,3937.000000000000000,4,807,1,25.0000000,807,1,25.0000000,822,1168
554,4.000000000000000,0.000277777777778,55,175,120,115.000000000000000,60.000000000000000,460.000000000000000,2,55,2,50.0000000,55,2,50.0000000,55,175
555,4.000000000000000,0.000277777777778,1065,2106,1041,1489.500000000000000,440.960599146907896,5958.000000000000000,4,1065,1,25.0000000,1065,1,25.0000000,1078,2106
556,4.000000000000000,0.000277777777778,642,4819,4177,1780.000000000000000,1759.247424326663577,7120.000000000000000,4,642,1,25.0000000,642,1,25.0000000,684,4819
557,3.000000000000000,0.000208333333333,561,855,294,744.666666666666629,130.747424023912941,2234.000000000000000,3,561,1,33.3333015,561,1,33.3333015,818,855
558,4.000000000000000,0.000277777777778,11,296,285,88.000000000000000,120.297547772180295,352.000000000000000,4,11,1,25.0000000,11,1,25.0000000,15,296
559,4.000000000000000,0.000277777777778,326,1713,1387,1018.750000000000000,685.300071136724796,4075.000000000000000,4,326,1,25.0000000,326,1,25.0000000,341,1713
560,4.000000000000000,0.000277777777778,286,1860,1574,1000.750000000000000,636.066574738839790,4003.000000000000000,4,286,1,25.0000000,286,1,25.0000000,505,1860
561,4.000000000000000,0.000277777777778,286,1860,1574,1000.750000000000000,636.066574738839790,4003.000000000000000,4,286,1,25.0000000,286,1,25.0000000,505,1860
562,4.000000000000000,0.000277777777778,735,1987,1252,1356.250000000000000,446.688579997295221,5425.000000000000000,4,735,1,25.0000000,735,1,25.0000000,1267,1987
563,4.000000000000000,0.000277777777778,0,62,62,27.250000000000000,24.200981385059574,109.000000000000000,4,0,1,25.0000000,0,1,25.0000000,10,62
564,5.000000000000000,0.000347222222222,25,79,54,39.200000000000003,20.960916010518243,196.000000000000000,3,25,3,60.0000000,42,1,20.0000000,25,79
565,4.000000000000000,0.000277777777778,1076,1441,365,1185.250000000000000,148.388636694323736,4741.000000000000000,4,1076,1,25.0000000,1076,1,25.0000000,1111,1441
566,5.000000000000000,0.000347222222222,304,1483,1179,920.600000000000023,391.799744767655454,4603.000000000000000,5,304,1,20.0000000,304,1,20.0000000,862,1483
567,4.000000000000000,0.000277777777778,304,1212,908,882.500000000000000,359.264178565022007,3530.000000000000000,4,304,1,25.0000000,304,1,25.0000000,862,1212
568,4.000000000000000,0.000277777777778,304,1152,848,758.750000000000000,301.515650505906592,3035.000000000000000,4,304,1,25.0000000,304,1,25.0000000,777,1152
569,3.000000000000000,0.000208333333333,31,1617,1586,566.666666666666742,742.747302624220652,1700.000000000000000,3,31,1,33.3333015,31,1,33.3333015,52,1617
570,5.000000000000000,0.000347222222222,680,1335,655,1060.000000000000000,228.404027985497663,5300.000000000000000,5,680,1,20.0000000,680,1,20.0000000,1041,1335
571,5.000000000000000,0.000347222222222,292,1391,1099,619.799999999999955,427.225654660391342,3099.000000000000000,5,292,1,20.0000000,292,1,20.0000000,336,1391
572,4.000000000000000,0.000277777777778,72,1139,1067,459.750000000000000,412.936057398721232,1839.000000000000000,4,72,1,25.0000000,72,1,25.0000000,196,1139
573,4.000000000000000,0.000277777777778,196,1139,943,491.250000000000000,386.088963193717802,1965.000000000000000,4,196,1,25.0000000,196,1,25.0000000,198,1139
574,4.000000000000000,0.000277777777778,35,1049,1014,547.750000000000000,394.149321323784591,2191.000000000000000,4,35,1,25.0000000,35,1,25.0000000,322,1049
575,4.000000000000000,0.000277777777778,35,1049,1014,351.750000000000000,408.736697031230619,1407.000000000000000,4,35,1,25.0000000,35,1,25.0000000,93,1049
576,4.000000000000000,0.000277777777778,35,1049,1014,547.750000000000000,394.149321323784591,2191.000000000000000,4,35,1,25.0000000,35,1,25.0000000,322,1049
577,4.000000000000000,0.000277777777778,2,26,24,11.750000000000000,9.601432184835760,47.000000000000000,4,2,1,25.0000000,2,1,25.0000000,4,26
578,4.000000000000000,0.000277777777778,0,62,62,18.500000000000000,25.588083163847973,74.000000000000000,3,0,2,50.0000000,12,1,25.0000000,0,62
579,5.000000000000000,0.000347222222222,888,1362,474,1056.000000000000000,173.357434221898899,5280.000000000000000,5,888,1,20.0000000,888,1,20.0000000,1008,1362
580,4.000000000000000,0.000277777777778,165,3176,3011,1207.000000000000000,1179.478062534441506,4828.000000000000000,4,165,1,25.0000000,165,1,25.0000000,450,3176
581,4.000000000000000,0.000277777777778,146,450,304,365.000000000000000,127.291005181041754,1460.000000000000000,3,450,2,50.0000000,146,1,25.0000000,414,450
582,4.000000000000000,0.000277777777778,258,5262,5004,1723.000000000000000,2055.283192165984929,6892.000000000000000,4,258,1,25.0000000,258,1,25.0000000,492,5262
583,4.000000000000000,0.000277777777778,7,350,343,114.500000000000000,140.079441746460418,458.000000000000000,4,7,1,25.0000000,7,1,25.0000000,10,350
584,4.000000000000000,0.000277777777778,1224,3319,2095,2080.500000000000000,869.441918704176601,8322.000000000000000,4,1224,1,25.0000000,1224,1,25.0000000,1305,3319
585,4.000000000000000,0.000277777777778,707,1191,484,958.750000000000000,172.496920262362977,3835.000000000000000,4,707,1,25.0000000,707,1,25.0000000,941,1191
586,4.000000000000000,0.000277777777778,357,2225,1868,1218.750000000000000,861.901495241770704,4875.000000000000000,4,357,1,25.0000000,357,1,25.0000000,370,2225
587,4.000000000000000,0.000277777777778,576,1657,1081,1033.250000000000000,430.416876411694602,4133.000000000000000,4,576,1,25.0000000,576,1,25.0000000,696,1657
588,3.000000000000000,0.000208333333333,90,156,66,125.333333333333329,27.145697428669777,376.000000000000000,3,90,1,33.3333015,90,1,33.3333015,130,156
589,4.000000000000000,0.000277777777778,49,2540,2491,1384.000000000000000,889.328679398117742,5536.000000000000000,4,49,1,25.0000000,49,1,25.0000000,1353,2540
590,4.000000000000000,0.000277777777778,358,2616,2258,1132.000000000000000,883.020951053824092,4528.000000000000000,4,358,1,25.0000000,358,1,25.0000000,596,2616
591,3.000000000000000,0.000208333333333,385,1045,660,761.000000000000000,277.185858225126651,2283.000000000000000,3,385,1,33.3333015,385,1,33.3333015,853,1045
592,4.000000000000000,0.000277777777778,636,2459,1823,1302.750000000000000,689.446653121182408,5211.000000000000000,4,636,1,25.0000000,636,1,25.0000000,1052,2459
593,4.000000000000000,0.000277777777778,363,4033,3670,1551.000000000000000,1451.696765857112496,6204.000000000000000,4,363,1,25.0000000,363,1,25.0000000,802,4033
594,4.000000000000000,0.000277777777778,150,916,766,559.000000000000000,316.608591165811561,2236.000000000000000,4,150,1,25.0000000,150,1,25.0000000,356,916
595,4.000000000000000,0.000277777777778,734,1221,487,1014.750000000000000,179.014489637012332,4059.000000000000000,4,734,1,25.0000000,734,1,25.0000000,1007,1221
596,4.000000000000000,0.000277777777778,405,881,476,626.000000000000000,197.796612711138209,2504.000000000000000,4,405,1,25.0000000,405,1,25.0000000,464,881
597,4.000000000000000,0.000277777777778,66,365,299,188.500000000000000,119.374410993311287,754.000000000000000,4,66,1,25.0000000,66,1,25.0000000,93,365
598,4.000000000000000,0.000277777777778,173,492,319,323.000000000000000,113.426187452457384,1292.000000000000000,4,173,1,25.0000000,173,1,25.0000000,303,492
599,4.000000000000000,0.000277777777778,65,179,114,137.000000000000000,43.058100283221968,548.000000000000000,4,65,1,25.0000000,65,1,25.0000000,149,179
600,4.000000000000000,0.000277777777778,673,1020,347,794.750000000000000,133.518491228743301,3179.000000000000000,4,673,1,25.0000000,673,1,25.0000000,729,1020
601,4.000000000000000,0.000277777777778,186,1856,1670,1048.250000000000000,591.382437598547540,4193.000000000000000,4,186,1,25.0000000,186,1,25.0000000,1048,1856
602,4.000000000000000,0.000277777777778,452,1966,1514,1060.500000000000000,595.129187655923943,4242.000000000000000,4,452,1,25.0000000,452,1,25.0000000,610,1966
603,4.000000000000000,0.000277777777778,750,1939,1189,1129.000000000000000,473.636463967883287,4516.000000000000000,4,750,1,25.0000000,750,1,25.0000000,865,1939
604,4.000000000000000,0.000277777777778,79,2149,2070,739.500000000000000,829.382450983863123,2958.000000000000000,4,79,1,25.0000000,79,1,25.0000000,210,2149
605,2.000000000000000,0.000138888888889,589,620,31,604.500000000000000,15.500000000000000,1209.000000000000000,2,589,1,50.0000000,589,1,50.0000000,589,620
606,4.000000000000000,0.000277777777778,1730,2262,532,2023.000000000000000,236.027540765902984,8092.000000000000000,4,1730,1,25.0000000,1730,1,25.0000000,1852,2262
607,3.000000000000000,0.000208333333333,1047,2049,1002,1468.333333333333258,424.296542002825561,4405.000000000000000,3,1047,1,33.3333015,1047,1,33.3333015,1309,2049
608,4.000000000000000,0.000277777777778,989,1436,447,1204.250000000000000,183.728570178946313,4817.000000000000000,4,989,1,25.0000000,989,1,25.0000000,1064,1436
609,4.000000000000000,0.000277777777778,140,2165,2025,860.250000000000000,773.413658723454432,3441.000000000000000,4,140,1,25.0000000,140,1,25.0000000,549,2165
610,4.000000000000000,0.000277777777778,82,1274,1192,834.000000000000000,483.421141449150923,3336.000000000000000,4,82,1,25.0000000,82,1,25.0000000,738,1274
611,4.000000000000000,0.000277777777778,637,1831,1194,1087.750000000000000,470.015624740284579,4351.000000000000000,4,637,1,25.0000000,637,1,25.0000000,735,1831
612,4.000000000000000,0.000277777777778,32,759,727,459.250000000000000,273.917300475891807,1837.000000000000000,4,32,1,25.0000000,32,1,25.0000000,424,759
613,4.000000000000000,0.000277777777778,239,1964,1725,859.000000000000000,666.674208290676347,3436.000000000000000,4,239,1,25.0000000,239,1,25.0000000,451,1964
614,4.000000000000000,0.000277777777778,0,22428,22428,6974.750000000000000,9018.086919491295703,27899.000000000000000,4,0,1,25.0000000,0,1,25.0000000,1758,22428
615,4.000000000000000,0.000277777777778,0,22428,22428,6974.750000000000000,9018.086919491295703,27899.000000000000000,4,0,1,25.0000000,0,1,25.0000000,1758,22428
616,4.000000000000000,0.000277777777778,0,1297,1297,653.000000000000000,459.861392160724904,2612.000000000000000,4,0,1,25.0000000,0,1,25.0000000,609,1297
617,4.000000000000000,0.000277777777778,1080,2561,1481,1863.250000000000000,563.957168143113563,7453.000000000000000,4,1080,1,25.0000000,1080,1,25.0000000,1616,2561
618,4.000000000000000,0.000277777777778,230,3251,3021,1023.750000000000000,1286.896921862819681,4095.000000000000000,4,230,1,25.0000000,230,1,25.0000000,251,3251
619,4.000000000000000,0.000277777777778,911,1430,519,1154.500000000000000,207.620446969945618,4618.000000000000000,4,911,1,25.0000000,911,1,25.0000000,1003,1430
620,4.000000000000000,0.000277777777778,309,3925,3616,1621.000000000000000,1372.705358043014257,6484.000000000000000,4,309,1,25.0000000,309,1,25.0000000,1037,3925
621,4.000000000000000,0.000277777777778,33,69,36,47.750000000000000,15.449514555480375,191.000000000000000,3,33,2,50.0000000,56,1,25.0000000,33,69
622,5.000000000000000,0.000347222222222,19926,130604,110678,68161.600000000005821,42106.330557767680148,340808.000000000000000,5,19926,1,20.0000000,19926,1,20.0000000,61233,130604
623,5.000000000000000,0.000347222222222,28,11535,11507,3796.800000000000182,4200.455184857945824,18984.000000000000000,5,28,1,20.0000000,28,1,20.0000000,1585,11535
624,3.000000000000000,0.000208333333333,1052,1895,843,1488.666666666666742,344.821048597030313,4466.000000000000000,3,1052,1,33.3333015,1052,1,33.3333015,1519,1895
625,4.000000000000000,0.000277777777778,420,1617,1197,828.500000000000000,464.695868283762593,3314.000000000000000,4,420,1,25.0000000,420,1,25.0000000,600,1617
626,4.000000000000000,0.000277777777778,242,3678,3436,2048.000000000000000,1224.551550568615312,8192.000000000000000,4,242,1,25.0000000,242,1,25.0000000,1957,3678
627,4.000000000000000,0.000277777777778,1371,2226,855,1634.500000000000000,344.500000000000000,6538.000000000000000,4,1371,1,25.0000000,1371,1,25.0000000,1442,2226
628,4.000000000000000,0.000277777777778,1093,2024,931,1509.250000000000000,333.329697896842049,6037.000000000000000,4,1093,1,25.0000000,1093,1,25.0000000,1434,2024
629,4.000000000000000,0.000277777777778,725,4003,3278,1730.750000000000000,1326.958623130352180,6923.000000000000000,4,725,1,25.0000000,725,1,25.0000000,915,4003
630,4.000000000000000,0.000277777777778,142,1282,1140,834.000000000000000,427.728886094918778,3336.000000000000000,4,142,1,25.0000000,142,1,25.0000000,850,1282
631,4.000000000000000,0.000277777777778,0,1089,1089,293.250000000000000,460.490160046878771,1173.000000000000000,4,0,1,25.0000000,0,1,25.0000000,5,1089
632,4.000000000000000,0.000277777777778,804,2326,1522,1724.750000000000000,621.557469185271771,6899.000000000000000,4,804,1,25.0000000,804,1,25.0000000,1507,2326
633,4.000000000000000,0.000277777777778,1361,3935,2574,2583.000000000000000,912.404241550859979,10332.000000000000000,4,1361,1,25.0000000,1361,1,25.0000000,2506,3935
634,3.000000000000000,0.000208333333333,605,677,72,652.333333333333371,33.479678745305918,1957.000000000000000,3,605,1,33.3333015,605,1,33.3333015,675,677
635,5.000000000000000,0.000347222222222,68,445,377,267.000000000000000,164.825968827730549,1335.000000000000000,5,68,1,20.0000000,68,1,20.0000000,335,445
636,4.000000000000000,0.000277777777778,499,903,404,727.750000000000000,158.220376374220535,2911.000000000000000,4,499,1,25.0000000,499,1,25.0000000,666,903
637,4.000000000000000,0.000277777777778,517,1280,763,770.750000000000000,300.248542877396801,3083.000000000000000,4,517,1,25.0000000,517,1,25.0000000,597,1280
638,4.000000000000000,0.000277777777778,517,1280,763,770.750000000000000,300.248542877396801,3083.000000000000000,4,517,1,25.0000000,517,1,25.0000000,597,1280
639,4.000000000000000,0.000277777777778,292,1344,1052,902.250000000000000,446.166098555235408,3609.000000000000000,4,292,1,25.0000000,292,1,25.0000000,659,1344
640,4.000000000000000,0.000277777777778,22,748,726,344.250000000000000,280.571180808008137,1377.000000000000000,4,22,1,25.0000000,22,1,25.0000000,154,748
641,5.000000000000000,0.000347222222222,150,2000,1850,747.600000000000023,662.121922307364684,3738.000000000000000,5,150,1,20.0000000,150,1,20.0000000,418,2000
642,4.000000000000000,0.000277777777778,379,3316,2937,1263.250000000000000,1192.465801396417419,5053.000000000000000,4,379,1,25.0000000,379,1,25.0000000,610,3316
643,4.000000000000000,0.000277777777778,28,4880,4852,1483.000000000000000,1996.032815361510984,5932.000000000000000,4,28,1,25.0000000,28,1,25.0000000,68,4880
644,5.000000000000000,0.000347222222222,224,1051,827,759.600000000000023,291.006941497964988,3798.000000000000000,5,224,1,20.0000000,224,1,20.0000000,812,1051
645,4.000000000000000,0.000277777777778,1076,1988,912,1688.250000000000000,371.447422255155800,6753.000000000000000,4,1076,1,25.0000000,1076,1,25.0000000,1706,1988
646,3.000000000000000,0.000208333333333,181,775,594,546.333333333333371,261.045760143483051,1639.000000000000000,3,181,1,33.3333015,181,1,33.3333015,683,775
647,4.000000000000000,0.000277777777778,215,5272,5057,1680.250000000000000,2080.970251469251707,6721.000000000000000,4,215,1,25.0000000,215,1,25.0000000,536,5272
648,4.000000000000000,0.000277777777778,2827,12716,9889,6821.750000000000000,4117.548990297505043,27287.000000000000000,4,2827,1,25.0000000,2827,1,25.0000000,3105,12716
649,4.000000000000000,0.000277777777778,221,748,527,492.000000000000000,187.412646318224773,1968.000000000000000,4,221,1,25.0000000,221,1,25.0000000,473,748
650,5.000000000000000,0.000347222222222,220,1801,1581,902.799999999999955,511.739543127165462,4514.000000000000000,5,220,1,20.0000000,220,1,20.0000000,846,1801
651,4.000000000000000,0.000277777777778,67,233,166,133.000000000000000,64.015623093116886,532.000000000000000,4,67,1,25.0000000,67,1,25.0000000,89,233
652,4.000000000000000,0.000277777777778,607,1521,914,1020.500000000000000,333.944231871131421,4082.000000000000000,4,607,1,25.0000000,607,1,25.0000000,875,1521
653,4.000000000000000,0.000277777777778,152,879,727,476.500000000000000,277.069034718786270,1906.000000000000000,4,152,1,25.0000000,152,1,25.0000000,302,879
654,4.000000000000000,0.000277777777778,114,3305,3191,1169.250000000000000,1256.105961891750667,4677.000000000000000,4,114,1,25.0000000,114,1,25.0000000,467,3305
655,5.000000000000000,0.000347222222222,143,371,228,243.599999999999994,80.368152896529850,1218.000000000000000,5,143,1,20.0000000,143,1,20.0000000,251,371
656,4.000000000000000,0.000277777777778,72,278,206,167.000000000000000,74.138384120508050,668.000000000000000,4,72,1,25.0000000,72,1,25.0000000,143,278
657,4.000000000000000,0.000277777777778,65,730,665,445.500000000000000,253.480275366743285,1782.000000000000000,4,65,1,25.0000000,65,1,25.0000000,378,730
658,4.000000000000000,0.000277777777778,207,945,738,530.750000000000000,264.941856829003143,2123.000000000000000,4,207,1,25.0000000,207,1,25.0000000,474,945
659,4.000000000000000,0.000277777777778,70,732,662,329.500000000000000,262.432372240926099,1318.000000000000000,4,70,1,25.0000000,70,1,25.0000000,124,732
660,4.000000000000000,0.000277777777778,0,22428,22428,6974.750000000000000,9018.086919491295703,27899.000000000000000,4,0,1,25.0000000,0,1,25.0000000,1758,22428
661,5.000000000000000,0.000347222222222,12,2901,2889,860.000000000000000,1118.077814823279596,4300.000000000000000,5,12,1,20.0000000,12,1,20.0000000,139,2901
662,5.000000000000000,0.000347222222222,448,5305,4857,3006.800000000000182,1673.340778203889840,15034.000000000000000,5,448,1,20.0000000,448,1,20.0000000,2857,5305
663,5.000000000000000,0.000347222222222,846,7075,6229,2266.800000000000182,2410.844864357721235,11334.000000000000000,5,846,1,20.0000000,846,1,20.0000000,1045,7075
664,4.000000000000000,0.000277777777778,4542,10661,6119,7904.500000000000000,2185.855724882134382,31618.000000000000000,4,4542,1,25.0000000,4542,1,25.0000000,8099,10661
665,4.000000000000000,0.000277777777778,31,2445,2414,932.500000000000000,916.408615193026208,3730.000000000000000,4,31,1,25.0000000,31,1,25.0000000,437,2445
666,4.000000000000000,0.000277777777778,3105,41692,38587,14975.250000000000000,15547.450343625478126,59901.000000000000000,4,3105,1,25.0000000,3105,1,25.0000000,6553,41692
667,4.000000000000000,0.000277777777778,463,1452,989,1007.000000000000000,381.075451846481428,4028.000000000000000,4,463,1,25.0000000,463,1,25.0000000,854,1452
668,3.000000000000000,0.000208333333333,892,2066,1174,1361.666666666666742,507.195119149316042,4085.000000000000000,3,892,1,33.3333015,892,1,33.3333015,1127,2066
669,4.000000000000000,0.000277777777778,823,4139,3316,2103.250000000000000,1328.659921688014265,8413.000000000000000,4,823,1,25.0000000,823,1,25.0000000,1021,4139
670,3.000000000000000,0.000208333333333,1021,4139,3118,2530.000000000000000,1274.880648008536809,7590.000000000000000,3,1021,1,33.3333015,1021,1,33.3333015,2430,4139
671,4.000000000000000,0.000277777777778,646,1361,715,1068.500000000000000,305.496726660041304,4274.000000000000000,4,646,1,25.0000000,646,1,25.0000000,909,1361
672,4.000000000000000,0.000277777777778,48,2344,2296,671.500000000000000,968.995743024704893,2686.000000000000000,3,48,2,50.0000000,246,1,25.0000000,48,2344
673,4.000000000000000,0.000277777777778,1,2185,2184,765.000000000000000,856.495183874375357,3060.000000000000000,4,1,1,25.0000000,1,1,25.0000000,193,2185
674,3.000000000000000,0.000208333333333,774,2289,1515,1288.000000000000000,707.899710411015803,3864.000000000000000,3,774,1,33.3333015,774,1,33.3333015,801,2289
675,4.000000000000000,0.000277777777778,133,718,585,453.250000000000000,255.304107879211386,1813.000000000000000,4,133,1,25.0000000,133,1,25.0000000,273,718
676,4.000000000000000,0.000277777777778,522,3801,3279,1524.000000000000000,1335.492231351421879,6096.000000000000000,4,522,1,25.0000000,522,1,25.0000000,629,3801
677,4.000000000000000,0.000277777777778,369,821,452,674.250000000000000,181.382710035989930,2697.000000000000000,4,369,1,25.0000000,369,1,25.0000000,707,821
678,4.000000000000000,0.000277777777778,369,821,452,674.250000000000000,181.382710035989930,2697.000000000000000,4,369,1,25.0000000,369,1,25.0000000,707,821
679,4.000000000000000,0.000277777777778,18088,76763,58675,56906.750000000000000,22845.455460276996746,227627.000000000000000,4,18088,1,25.0000000,18088,1,25.0000000,64557,76763
680,4.000000000000000,0.000277777777778,18088,76763,58675,56906.750000000000000,22845.455460276996746,227627.000000000000000,4,18088,1,25.0000000,18088,1,25.0000000,64557,76763
681,4.000000000000000,0.000277777777778,142,2430,2288,944.750000000000000,879.946411720622791,3779.000000000000000,4,142,1,25.0000000,142,1,25.0000000,520,2430
682,4.000000000000000,0.000277777777778,1,1091,1090,444.000000000000000,431.078299152253805,1776.000000000000000,4,1,1,25.0000000,1,1,25.0000000,110,1091
683,4.000000000000000,0.000277777777778,367,1106,739,740.250000000000000,261.311476020476391,2961.000000000000000,4,367,1,25.0000000,367,1,25.0000000,741,1106
684,4.000000000000000,0.000277777777778,651,3549,2898,1672.750000000000000,1185.293713600135561,6691.000000000000000,4,651,1,25.0000000,651,1,25.0000000,658,3549
685,4.000000000000000,0.000277777777778,232,3549,3317,1279.250000000000000,1322.492982022966999,5117.000000000000000,4,232,1,25.0000000,232,1,25.0000000,658,3549
686,4.000000000000000,0.000277777777778,232,3549,3317,1279.250000000000000,1322.492982022966999,5117.000000000000000,4,232,1,25.0000000,232,1,25.0000000,658,3549
687,4.000000000000000,0.000277777777778,34,206,172,137.000000000000000,63.462587403918548,548.000000000000000,4,34,1,25.0000000,34,1,25.0000000,145,206
688,4.000000000000000,0.000277777777778,463,3348,2885,1396.000000000000000,1153.311969937015874,5584.000000000000000,4,463,1,25.0000000,463,1,25.0000000,641,3348
689,4.000000000000000,0.000277777777778,15646,63807,48161,34500.750000000000000,17910.448450206375128,138003.000000000000000,4,15646,1,25.0000000,15646,1,25.0000000,26614,63807
690,4.000000000000000,0.000277777777778,533,974,441,696.750000000000000,167.865087198023389,2787.000000000000000,4,533,1,25.0000000,533,1,25.0000000,604,974
691,4.000000000000000,0.000277777777778,343,1017,674,791.500000000000000,265.093851305532951,3166.000000000000000,4,343,1,25.0000000,343,1,25.0000000,857,1017
692,4.000000000000000,0.000277777777778,9420,31391,21971,17038.250000000000000,8671.535601466443040,68153.000000000000000,4,9420,1,25.0000000,9420,1,25.0000000,11019,31391
693,4.000000000000000,0.000277777777778,520,2645,2125,1360.000000000000000,821.180552619215405,5440.000000000000000,4,520,1,25.0000000,520,1,25.0000000,790,2645
694,3.000000000000000,0.000208333333333,590,2725,2135,1366.000000000000000,964.182901044540699,4098.000000000000000,3,590,1,33.3333015,590,1,33.3333015,783,2725
695,4.000000000000000,0.000277777777778,549,1099,550,772.750000000000000,205.163806505923446,3091.000000000000000,4,549,1,25.0000000,549,1,25.0000000,664,1099
696,4.000000000000000,0.000277777777778,708,2282,1574,1188.750000000000000,640.885081352343491,4755.000000000000000,4,708,1,25.0000000,708,1,25.0000000,762,2282
697,4.000000000000000,0.000277777777778,1047,1325,278,1161.500000000000000,118.147154007195624,4646.000000000000000,4,1047,1,25.0000000,1047,1,25.0000000,1051,1325
698,4.000000000000000,0.000277777777778,656,6046,5390,2556.250000000000000,2090.587522085597811,10225.000000000000000,4,656,1,25.0000000,656,1,25.0000000,1298,6046
699,4.000000000000000,0.000277777777778,546,929,383,783.250000000000000,143.435307717451479,3133.000000000000000,4,546,1,25.0000000,546,1,25.0000000,812,929
700,5.000000000000000,0.000347222222222,559,3986,3427,1532.199999999999818,1246.917703780004786,7661.000000000000000,5,559,1,20.0000000,559,1,20.0000000,1150,3986
701,4.000000000000000,0.000277777777778,121,1013,892,437.750000000000000,361.759156760405972,1751.000000000000000,4,121,1,25.0000000,121,1,25.0000000,137,1013
702,4.000000000000000,0.000277777777778,103,3720,3617,1420.250000000000000,1409.151229464034486,5681.000000000000000,4,103,1,25.0000000,103,1,25.0000000,462,3720
703,5.000000000000000,0.000347222222222,1613,6918,5305,5587.600000000000364,1995.735914393485018,27938.000000000000000,5,1613,1,20.0000000,1613,1,20.0000000,6434,6918
704,4.000000000000000,0.000277777777778,147,439,292,311.500000000000000,109.200503661842149,1246.000000000000000,4,147,1,25.0000000,147,1,25.0000000,287,439
705,4.000000000000000,0.000277777777778,131,7026,6895,2406.500000000000000,2780.908709396984250,9626.000000000000000,4,131,1,25.0000000,131,1,25.0000000,321,7026
706,5.000000000000000,0.000347222222222,113,775,662,447.199999999999989,287.951662610237406,2236.000000000000000,5,113,1,20.0000000,113,1,20.0000000,491,775
707,4.000000000000000,0.000277777777778,28,911,883,520.000000000000000,387.833082652834037,2080.000000000000000,4,28,1,25.0000000,28,1,25.0000000,253,911
708,4.000000000000000,0.000277777777778,386,3666,3280,1720.500000000000000,1358.615011693894076,6882.000000000000000,4,386,1,25.0000000,386,1,25.0000000,512,3666
709,4.000000000000000,0.000277777777778,25,1856,1831,772.500000000000000,774.546480206320439,3090.000000000000000,4,25,1,25.0000000,25,1,25.0000000,52,1856
710,4.000000000000000,0.000277777777778,59,355,296,194.250000000000000,105.993808781456664,777.000000000000000,4,59,1,25.0000000,59,1,25.0000000,166,355
711,3.000000000000000,0.000208333333333,85,1887,1802,797.333333333333371,782.554080488300087,2392.000000000000000,3,85,1,33.3333015,85,1,33.3333015,420,1887
712,3.000000000000000,0.000208333333333,0,125,125,41.666666666666671,58.925565098878963,125.000000000000000,2,0,2,66.6667023,125,1,33.3333015,0,125
713,5.000000000000000,0.000347222222222,47,715,668,386.600000000000023,228.620733967853397,1933.000000000000000,5,47,1,20.0000000,47,1,20.0000000,376,715
714,4.000000000000000,0.000277777777778,1,645,644,171.750000000000000,273.352679701516763,687.000000000000000,4,1,1,25.0000000,1,1,25.0000000,18,645
715,4.000000000000000,0.000277777777778,34543,92952,58409,56413.500000000000000,23309.300595470471308,225654.000000000000000,4,34543,1,25.0000000,34543,1,25.0000000,37847,92952
716,4.000000000000000,0.000277777777778,254,700,446,517.000000000000000,183.478881618566675,2068.000000000000000,4,254,1,25.0000000,254,1,25.0000000,437,700
717,4.000000000000000,0.000277777777778,272,833,561,561.000000000000000,198.540927770573290,2244.000000000000000,4,272,1,25.0000000,272,1,25.0000000,566,833
718,4.000000000000000,0.000277777777778,360,1496,1136,826.750000000000000,415.050222864655268,3307.000000000000000,4,360,1,25.0000000,360,1,25.0000000,688,1496
719,4.000000000000000,0.000277777777778,27,265,238,96.000000000000000,98.135110944044897,384.000000000000000,4,27,1,25.0000000,27,1,25.0000000,36,265
720,4.000000000000000,0.000277777777778,27,2416,2389,691.000000000000000,1000.152738335500430,2764.000000000000000,4,27,1,25.0000000,27,1,25.0000000,56,2416
721,4.000000000000000,0.000277777777778,60,1703,1643,1129.250000000000000,650.393102285071905,4517.000000000000000,4,60,1,25.0000000,60,1,25.0000000,1157,1703
722,4.000000000000000,0.000277777777778,330,1598,1268,1019.000000000000000,541.726406962038368,4076.000000000000000,4,330,1,25.0000000,330,1,25.0000000,651,1598
723,4.000000000000000,0.000277777777778,330,1846,1516,1043.750000000000000,642.645460187808453,4175.000000000000000,4,330,1,25.0000000,330,1,25.0000000,502,1846
724,5.000000000000000,0.000347222222222,330,1846,1516,1184.400000000000091,586.687855677957600,5922.000000000000000,5,330,1,20.0000000,330,1,20.0000000,1497,1846
725,4.000000000000000,0.000277777777778,330,1846,1516,1043.750000000000000,642.645460187808453,4175.000000000000000,4,330,1,25.0000000,330,1,25.0000000,502,1846
726,4.000000000000000,0.000277777777778,190,1432,1242,919.250000000000000,522.660202713005447,3677.000000000000000,4,190,1,25.0000000,190,1,25.0000000,657,1432
727,4.000000000000000,0.000277777777778,498,4181,3683,1876.500000000000000,1423.155033719095627,7506.000000000000000,4,498,1,25.0000000,498,1,25.0000000,933,4181
728,4.000000000000000,0.000277777777778,498,4181,3683,1876.500000000000000,1423.155033719095627,7506.000000000000000,4,498,1,25.0000000,498,1,25.0000000,933,4181
729,4.000000000000000,0.000277777777778,539,5653,5114,2121.250000000000000,2057.496096594109986,8485.000000000000000,4,539,1,25.0000000,539,1,25.0000000,979,5653
730,4.000000000000000,0.000277777777778,1874,6285,4411,3617.000000000000000,1666.538178380561476,14468.000000000000000,4,1874,1,25.0000000,1874,1,25.0000000,2642,6285
731,4.000000000000000,0.000277777777778,398,1243,845,996.500000000000000,348.165549703011266,3986.000000000000000,4,398,1,25.0000000,398,1,25.0000000,1128,1243
732,4.000000000000000,0.000277777777778,702,6041,5339,2125.500000000000000,2262.528287115986586,8502.000000000000000,4,702,1,25.0000000,702,1,25.0000000,797,6041
733,4.000000000000000,0.000277777777778,705,1131,426,932.000000000000000,166.974548958815888,3728.000000000000000,4,705,1,25.0000000,705,1,25.0000000,846,1131
734,4.000000000000000,0.000277777777778,28,349,321,127.500000000000000,129.823919213679574,510.000000000000000,4,28,1,25.0000000,28,1,25.0000000,44,349
735,4.000000000000000,0.000277777777778,638,1227,589,975.250000000000000,235.713146642269407,3901.000000000000000,4,638,1,25.0000000,638,1,25.0000000,874,1227
736,4.000000000000000,0.000277777777778,66,2134,2068,654.000000000000000,861.668149579639476,2616.000000000000000,4,66,1,25.0000000,66,1,25.0000000,74,2134
737,4.000000000000000,0.000277777777778,510,893,383,667.000000000000000,155.818805026864453,2668.000000000000000,4,510,1,25.0000000,510,1,25.0000000,535,893
738,4.000000000000000,0.000277777777778,225,822,597,467.750000000000000,233.965141634389624,1871.000000000000000,4,225,1,25.0000000,225,1,25.0000000,293,822
739,4.000000000000000,0.000277777777778,217,747,530,496.250000000000000,193.379646033392049,1985.000000000000000,4,217,1,25.0000000,217,1,25.0000000,446,747
740,4.000000000000000,0.000277777777778,718,1081,363,864.250000000000000,133.092777790532267,3457.000000000000000,3,829,2,50.0000000,718,1,25.0000000,829,1081
741,5.000000000000000,0.000347222222222,34,916,882,288.399999999999977,318.132425257156058,1442.000000000000000,5,34,1,20.0000000,34,1,20.0000000,163,916
742,3.000000000000000,0.000208333333333,1861,2066,205,1960.333333333333258,83.810633109541811,5881.000000000000000,3,1861,1,33.3333015,1861,1,33.3333015,1954,2066
743,4.000000000000000,0.000277777777778,469,3699,3230,1462.750000000000000,1300.159677693474805,5851.000000000000000,4,469,1,25.0000000,469,1,25.0000000,815,3699
744,4.000000000000000,0.000277777777778,398,1112,714,867.250000000000000,277.607073937246753,3469.000000000000000,4,398,1,25.0000000,398,1,25.0000000,941,1112
745,3.000000000000000,0.000208333333333,373,2095,1722,1443.333333333333258,762.794132704813705,4330.000000000000000,3,373,1,33.3333015,373,1,33.3333015,1862,2095
746,4.000000000000000,0.000277777777778,33,1694,1661,796.000000000000000,591.279544716371902,3184.000000000000000,4,33,1,25.0000000,33,1,25.0000000,709,1694
747,4.000000000000000,0.000277777777778,110,6781,6671,2397.250000000000000,2582.570945298502465,9589.000000000000000,4,110,1,25.0000000,110,1,25.0000000,1222,6781
748,4.000000000000000,0.000277777777778,1039,6781,5742,2707.750000000000000,2359.483139905856660,10831.000000000000000,4,1039,1,25.0000000,1039,1,25.0000000,1476,6781
749,4.000000000000000,0.000277777777778,0,1297,1297,709.250000000000000,464.773802510425469,2837.000000000000000,4,0,1,25.0000000,0,1,25.0000000,706,1297
750,4.000000000000000,0.000277777777778,185,862,677,554.250000000000000,249.216146146271996,2217.000000000000000,4,185,1,25.0000000,185,1,25.0000000,497,862
751,4.000000000000000,0.000277777777778,27861,78173,50312,49435.750000000000000,18174.429831152887346,197743.000000000000000,4,27861,1,25.0000000,27861,1,25.0000000,44390,78173
752,4.000000000000000,0.000277777777778,27861,78173,50312,49435.750000000000000,18174.429831152887346,197743.000000000000000,4,27861,1,25.0000000,27861,1,25.0000000,44390,78173
753,4.000000000000000,0.000277777777778,233,2835,2602,1003.250000000000000,1066.258499379958039,4013.000000000000000,4,233,1,25.0000000,233,1,25.0000000,339,2835
754,4.000000000000000,0.000277777777778,233,606,373,378.500000000000000,138.105937598642015,1514.000000000000000,4,233,1,25.0000000,233,1,25.0000000,336,606
755,4.000000000000000,0.000277777777778,325,1846,1521,832.250000000000000,596.892107084689087,3329.000000000000000,4,325,1,25.0000000,325,1,25.0000000,502,1846
756,4.000000000000000,0.000277777777778,325,1846,1521,832.250000000000000,596.892107084689087,3329.000000000000000,4,325,1,25.0000000,325,1,25.0000000,502,1846
757,4.000000000000000,0.000277777777778,325,1846,1521,832.250000000000000,596.892107084689087,3329.000000000000000,4,325,1,25.0000000,325,1,25.0000000,502,1846
758,4.000000000000000,0.000277777777778,150,1846,1696,744.250000000000000,661.540767829164110,2977.000000000000000,4,150,1,25.0000000,150,1,25.0000000,325,1846
759,5.000000000000000,0.000347222222222,681,1316,635,1067.400000000000091,216.156054738237657,5337.000000000000000,5,681,1,20.0000000,681,1,20.0000000,1103,1316
760,3.000000000000000,0.000208333333333,8,62,54,27.000000000000000,24.779023386727733,81.000000000000000,3,8,1,33.3333015,8,1,33.3333015,11,62
761,4.000000000000000,0.000277777777778,174,1071,897,648.750000000000000,395.026185840888274,2595.000000000000000,4,174,1,25.0000000,174,1,25.0000000,344,1071
762,4.000000000000000,0.000277777777778,186,2254,2068,926.250000000000000,787.951894153443845,3705.000000000000000,4,186,1,25.0000000,186,1,25.0000000,631,2254
763,4.000000000000000,0.000277777777778,486,1602,1116,1115.000000000000000,413.285615525147477,4460.000000000000000,4,486,1,25.0000000,486,1,25.0000000,1044,1602
764,4.000000000000000,0.000277777777778,513,3260,2747,1292.000000000000000,1139.444820954485749,5168.000000000000000,4,513,1,25.0000000,513,1,25.0000000,640,3260
765,5.000000000000000,0.000347222222222,641,3990,3349,1890.599999999999909,1349.820225067027195,9453.000000000000000,5,641,1,20.0000000,641,1,20.0000000,955,3990
766,4.000000000000000,0.000277777777778,1,168,167,44.000000000000000,71.606563944934550,176.000000000000000,4,1,1,25.0000000,1,1,25.0000000,2,168
767,4.000000000000000,0.000277777777778,349,987,638,649.000000000000000,227.424712817231040,2596.000000000000000,4,349,1,25.0000000,349,1,25.0000000,599,987
768,3.000000000000000,0.000208333333333,78,578,500,333.000000000000000,204.246582998753411,999.000000000000000,3,78,1,33.3333015,78,1,33.3333015,343,578
769,3.000000000000000,0.000208333333333,78,2846,2768,1049.333333333333485,1271.832623509171526,3148.000000000000000,3,78,1,33.3333015,78,1,33.3333015,224,2846
770,4.000000000000000,0.000277777777778,1159,2502,1343,1776.500000000000000,481.871611531536473,7106.000000000000000,4,1159,1,25.0000000,1159,1,25.0000000,1635,2502
771,4.000000000000000,0.000277777777778,232,3672,3440,1294.000000000000000,1396.912309345149879,5176.000000000000000,4,232,1,25.0000000,232,1,25.0000000,356,3672
772,4.000000000000000,0.000277777777778,0,42,42,11.250000000000000,17.795715776557007,45.000000000000000,3,0,2,50.0000000,3,1,25.0000000,0,42
773,4.000000000000000,0.000277777777778,635,16975,16340,6413.500000000000000,6272.395096771248063,25654.000000000000000,4,635,1,25.0000000,635,1,25.0000000,3316,16975
774,4.000000000000000,0.000277777777778,374,4382,4008,1618.500000000000000,1626.468644026069114,6474.000000000000000,4,374,1,25.0000000,374,1,25.0000000,511,4382
775,4.000000000000000,0.000277777777778,168,1758,1590,1064.000000000000000,581.975514948867954,4256.000000000000000,4,168,1,25.0000000,168,1,25.0000000,1007,1758
776,5.000000000000000,0.000347222222222,143,580,437,332.000000000000000,165.378354085412269,1660.000000000000000,5,143,1,20.0000000,143,1,20.0000000,312,580
777,4.000000000000000,0.000277777777778,34543,92952,58409,70607.250000000000000,21760.229736551493261,282429.000000000000000,4,34543,1,25.0000000,34543,1,25.0000000,77461,92952
778,4.000000000000000,0.000277777777778,363,4033,3670,1551.000000000000000,1451.696765857112496,6204.000000000000000,4,363,1,25.0000000,363,1,25.0000000,802,4033
779,4.000000000000000,0.000277777777778,845,942,97,909.250000000000000,39.397810852888767,3637.000000000000000,4,845,1,25.0000000,845,1,25.0000000,909,942
780,5.000000000000000,0.000347222222222,446,1802,1356,1088.799999999999955,555.996187037285381,5444.000000000000000,5,446,1,20.0000000,446,1,20.0000000,955,1802
781,4.000000000000000,0.000277777777778,155,2054,1899,964.000000000000000,711.355396408855540,3856.000000000000000,4,155,1,25.0000000,155,1,25.0000000,557,2054
782,4.000000000000000,0.000277777777778,57817,107496,49679,83934.500000000000000,18441.355542638397310,335738.000000000000000,4,57817,1,25.0000000,57817,1,25.0000000,77473,107496
783,4.000000000000000,0.000277777777778,59,207,148,128.250000000000000,65.158940292180930,513.000000000000000,4,59,1,25.0000000,59,1,25.0000000,69,207
784,4.000000000000000,0.000277777777778,142,1282,1140,834.000000000000000,427.728886094918778,3336.000000000000000,4,142,1,25.0000000,142,1,25.0000000,850,1282
785,4.000000000000000,0.000277777777778,142,1282,1140,834.000000000000000,427.728886094918778,3336.000000000000000,4,142,1,25.0000000,142,1,25.0000000,850,1282
786,4.000000000000000,0.000277777777778,317,2456,2139,1059.500000000000000,827.819575753074332,4238.000000000000000,4,317,1,25.0000000,317,1,25.0000000,619,2456
787,3.000000000000000,0.000208333333333,399,1183,784,886.333333333333371,347.303261654070184,2659.000000000000000,3,399,1,33.3333015,399,1,33.3333015,1077,1183
788,4.000000000000000,0.000277777777778,400,2954,2554,1367.750000000000000,1046.674824145493631,5471.000000000000000,4,400,1,25.0000000,400,1,25.0000000,451,2954
789,3.000000000000000,0.000208333333333,20756,108548,87792,53317.000000000000000,39262.411973794987716,159951.000000000000000,3,20756,1,33.3333015,20756,1,33.3333015,30647,108548
790,4.000000000000000,0.000277777777778,31,523,492,230.500000000000000,198.747955964331879,922.000000000000000,4,31,1,25.0000000,31,1,25.0000000,65,523
791,4.000000000000000,0.000277777777778,122,1643,1521,1218.250000000000000,636.481097519792797,4873.000000000000000,4,122,1,25.0000000,122,1,25.0000000,1474,1643
792,4.000000000000000,0.000277777777778,17,848,831,381.000000000000000,345.833052208721085,1524.000000000000000,4,17,1,25.0000000,17,1,25.0000000,82,848
793,4.000000000000000,0.000277777777778,232,3090,2858,1620.500000000000000,1324.654955073207020,6482.000000000000000,4,232,1,25.0000000,232,1,25.0000000,370,3090
794,4.000000000000000,0.000277777777778,66,1925,1859,915.750000000000000,670.971823178887348,3663.000000000000000,4,66,1,25.0000000,66,1,25.0000000,682,1925
795,4.000000000000000,0.000277777777778,388,765,377,570.500000000000000,175.622464394507347,2282.000000000000000,4,388,1,25.0000000,388,1,25.0000000,403,765
796,3.000000000000000,0.000208333333333,1583,39086,37503,14715.333333333333940,17250.002016102942434,44146.000000000000000,3,1583,1,33.3333015,1583,1,33.3333015,3477,39086
797,4.000000000000000,0.000277777777778,33947,94332,60385,62704.500000000000000,28683.520673899151006,250818.000000000000000,4,33947,1,25.0000000,33947,1,25.0000000,34255,94332
798,3.000000000000000,0.000208333333333,908,5438,4530,2784.666666666666515,1929.185205094512412,8354.000000000000000,3,908,1,33.3333015,908,1,33.3333015,2008,5438
799,6.000000000000000,0.000416666666667,114,3183,3069,1367.833333333333258,955.917607444397959,8207.000000000000000,6,114,1,16.6667004,114,1,16.6667004,1128,1664
800,4.000000000000000,0.000277777777778,791,9703,8912,4247.250000000000000,3326.967716630264931,16989.000000000000000,4,791,1,25.0000000,791,1,25.0000000,2716,9703
801,4.000000000000000,0.000277777777778,34255,94332,60077,59042.500000000000000,23050.078682078288693,236170.000000000000000,4,34255,1,25.0000000,34255,1,25.0000000,43537,94332
802,4.000000000000000,0.000277777777778,34255,94332,60077,59042.500000000000000,23050.078682078288693,236170.000000000000000,4,34255,1,25.0000000,34255,1,25.0000000,43537,94332
803,4.000000000000000,0.000277777777778,34255,94332,60077,59042.500000000000000,23050.078682078288693,236170.000000000000000,4,34255,1,25.0000000,34255,1,25.0000000,43537,94332
804,4.000000000000000,0.000277777777778,1727,5443,3716,2804.500000000000000,1528.418218289745482,11218.000000000000000,4,1727,1,25.0000000,1727,1,25.0000000,1984,5443
805,4.000000000000000,0.000277777777778,292,1078,786,576.000000000000000,298.589182657376227,2304.000000000000000,4,292,1,25.0000000,292,1,25.0000000,457,1078
806,4.000000000000000,0.000277777777778,339,752,413,477.500000000000000,164.256658921335685,1910.000000000000000,4,339,1,25.0000000,339,1,25.0000000,364,752
807,4.000000000000000,0.000277777777778,3438,10790,7352,5457.000000000000000,3091.641877708348147,21828.000000000000000,4,3438,1,25.0000000,3438,1,25.0000000,3465,10790
808,3.000000000000000,0.000208333333333,181,775,594,546.333333333333371,261.045760143483051,1639.000000000000000,3,181,1,33.3333015,181,1,33.3333015,683,775
809,4.000000000000000,0.000277777777778,187,1760,1573,817.000000000000000,614.364305603768003,3268.000000000000000,4,187,1,25.0000000,187,1,25.0000000,365,1760
810,4.000000000000000,0.000277777777778,80,2692,2612,875.000000000000000,1058.091205898621865,3500.000000000000000,4,80,1,25.0000000,80,1,25.0000000,258,2692
811,3.000000000000000,0.000208333333333,708,7517,6809,3011.000000000000000,3186.484687969905281,9033.000000000000000,3,708,1,33.3333015,708,1,33.3333015,808,7517
812,4.000000000000000,0.000277777777778,1029,4513,3484,2380.500000000000000,1297.907643093298020,9522.000000000000000,4,1029,1,25.0000000,1029,1,25.0000000,1818,4513
813,4.000000000000000,0.000277777777778,680,1335,655,1076.500000000000000,252.684091307703824,4306.000000000000000,4,680,1,25.0000000,680,1,25.0000000,1041,1335
814,5.000000000000000,0.000347222222222,121,942,821,691.000000000000000,310.271494017739258,3455.000000000000000,5,121,1,20.0000000,121,1,20.0000000,845,942
815,4.000000000000000,0.000277777777778,150,916,766,559.000000000000000,316.608591165811561,2236.000000000000000,4,150,1,25.0000000,150,1,25.0000000,356,916
816,4.000000000000000,0.000277777777778,415,2609,2194,1120.000000000000000,890.299387846582817,4480.000000000000000,4,415,1,25.0000000,415,1,25.0000000,455,2609
817,4.000000000000000,0.000277777777778,147,1150,1003,779.750000000000000,378.253469911380989,3119.000000000000000,4,147,1,25.0000000,147,1,25.0000000,897,1150
818,4.000000000000000,0.000277777777778,147,1150,1003,779.750000000000000,378.253469911380989,3119.000000000000000,4,147,1,25.0000000,147,1,25.0000000,897,1150
819,3.000000000000000,0.000208333333333,568,1396,828,1054.000000000000000,353.032576400535618,3162.000000000000000,3,568,1,33.3333015,568,1,33.3333015,1198,1396
820,5.000000000000000,0.000347222222222,562,1006,444,730.399999999999977,198.933757819028784,3652.000000000000000,5,562,1,20.0000000,562,1,20.0000000,582,1006
821,3.000000000000000,0.000208333333333,232,3672,3440,1606.666666666666742,1486.868147782071901,4820.000000000000000,3,232,1,33.3333015,232,1,33.3333015,916,3672
822,4.000000000000000,0.000277777777778,621,1497,876,868.000000000000000,364.048073748509182,3472.000000000000000,4,621,1,25.0000000,621,1,25.0000000,661,1497
823,4.000000000000000,0.000277777777778,72,616,544,307.500000000000000,226.817658042754687,1230.000000000000000,4,72,1,25.0000000,72,1,25.0000000,109,616
824,4.000000000000000,0.000277777777778,862,996,134,896.000000000000000,57.736470276593813,3584.000000000000000,3,863,2,50.0000000,862,1,25.0000000,863,996
825,4.000000000000000,0.000277777777778,862,996,134,896.000000000000000,57.736470276593813,3584.000000000000000,3,863,2,50.0000000,862,1,25.0000000,863,996
826,3.000000000000000,0.000208333333333,85,929,844,367.333333333333371,397.160197177690804,1102.000000000000000,3,85,1,33.3333015,85,1,33.3333015,88,929
827,4.000000000000000,0.000277777777778,363,1621,1258,897.500000000000000,465.806021858884947,3590.000000000000000,4,363,1,25.0000000,363,1,25.0000000,660,1621
828,4.000000000000000,0.000277777777778,30,81,51,59.250000000000000,20.583670712484690,237.000000000000000,4,30,1,25.0000000,30,1,25.0000000,50,81
829,4.000000000000000,0.000277777777778,396,1418,1022,892.250000000000000,413.135797892170103,3569.000000000000000,4,396,1,25.0000000,396,1,25.0000000,595,1418
830,4.000000000000000,0.000277777777778,1822,33308,31486,10179.750000000000000,13366.629462489787329,40719.000000000000000,4,1822,1,25.0000000,1822,1,25.0000000,2156,33308
831,4.000000000000000,0.000277777777778,0,716,716,184.000000000000000,307.258848530030150,736.000000000000000,3,0,2,50.0000000,20,1,25.0000000,0,716
832,4.000000000000000,0.000277777777778,0,716,716,184.000000000000000,307.258848530030150,736.000000000000000,3,0,2,50.0000000,20,1,25.0000000,0,716
833,4.000000000000000,0.000277777777778,537,997,460,696.750000000000000,184.624449897623265,2787.000000000000000,4,537,1,25.0000000,537,1,25.0000000,553,997
834,4.000000000000000,0.000277777777778,72,607,535,396.000000000000000,209.335854549573043,1584.000000000000000,4,72,1,25.0000000,72,1,25.0000000,354,607
835,4.000000000000000,0.000277777777778,609,1950,1341,1090.000000000000000,528.782091224731289,4360.000000000000000,4,609,1,25.0000000,609,1,25.0000000,706,1950
836,5.000000000000000,0.000347222222222,803,2835,2032,1678.200000000000045,927.366464780779211,8391.000000000000000,5,803,1,20.0000000,803,1,20.0000000,1025,2835
837,4.000000000000000,0.000277777777778,803,2786,1983,1389.000000000000000,810.448949656916966,5556.000000000000000,4,803,1,25.0000000,803,1,25.0000000,942,2786
838,4.000000000000000,0.000277777777778,1047,2618,1571,1755.750000000000000,618.745252507039481,7023.000000000000000,4,1047,1,25.0000000,1047,1,25.0000000,1309,2618
839,4.000000000000000,0.000277777777778,711,1187,476,901.250000000000000,189.900467350662410,3605.000000000000000,4,711,1,25.0000000,711,1,25.0000000,749,1187
840,4.000000000000000,0.000277777777778,520,2645,2125,1360.000000000000000,821.180552619215405,5440.000000000000000,4,520,1,25.0000000,520,1,25.0000000,790,2645
841,4.000000000000000,0.000277777777778,4,161,157,50.249999999999993,64.511142448417388,201.000000000000000,4,4,1,25.0000000,4,1,25.0000000,9,161
842,4.000000000000000,0.000277777777778,4,161,157,50.249999999999993,64.511142448417388,201.000000000000000,4,4,1,25.0000000,4,1,25.0000000,9,161
843,5.000000000000000,0.000347222222222,24,149,125,75.799999999999997,45.039538185909500,379.000000000000000,5,24,1,20.0000000,24,1,20.0000000,61,149
844,4.000000000000000,0.000277777777778,14,1382,1368,706.750000000000000,655.938783347958520,2827.000000000000000,4,14,1,25.0000000,14,1,25.0000000,89,1382
845,4.000000000000000,0.000277777777778,125,1191,1066,590.500000000000000,461.750203031899048,2362.000000000000000,4,125,1,25.0000000,125,1,25.0000000,158,1191
846,4.000000000000000,0.000277777777778,530,3493,2963,1615.250000000000000,1124.570890384416771,6461.000000000000000,4,530,1,25.0000000,530,1,25.0000000,1076,3493
847,4.000000000000000,0.000277777777778,530,3493,2963,1615.250000000000000,1124.570890384416771,6461.000000000000000,4,530,1,25.0000000,530,1,25.0000000,1076,3493
848,3.000000000000000,0.000208333333333,966,1690,724,1431.000000000000000,329.515806398823088,4293.000000000000000,3,966,1,33.3333015,966,1,33.3333015,1637,1690
849,4.000000000000000,0.000277777777778,738,3069,2331,1419.000000000000000,957.373229205830626,5676.000000000000000,4,738,1,25.0000000,738,1,25.0000000,862,3069
850,5.000000000000000,0.000347222222222,725,3069,2344,1311.200000000000045,883.481839088953734,6556.000000000000000,5,725,1,20.0000000,725,1,20.0000000,893,3069
851,5.000000000000000,0.000347222222222,75,1263,1188,798.799999999999955,407.659858215154657,3994.000000000000000,5,75,1,20.0000000,75,1,20.0000000,899,1263
852,4.000000000000000,0.000277777777778,682,7771,7089,2751.750000000000000,2916.763306732309957,11007.000000000000000,4,682,1,25.0000000,682,1,25.0000000,958,7771
853,3.000000000000000,0.000208333333333,627,842,215,700.333333333333371,100.194255767927586,2101.000000000000000,3,627,1,33.3333015,627,1,33.3333015,632,842
854,5.000000000000000,0.000347222222222,1,802,801,210.800000000000011,300.245499549951660,1054.000000000000000,5,1,1,20.0000000,1,1,20.0000000,85,802
855,4.000000000000000,0.000277777777778,211,730,519,588.000000000000000,218.283073095464744,2352.000000000000000,4,211,1,25.0000000,211,1,25.0000000,687,730
856,4.000000000000000,0.000277777777778,687,2792,2105,1280.250000000000000,877.207607981143724,5121.000000000000000,4,687,1,25.0000000,687,1,25.0000000,724,2792
857,5.000000000000000,0.000347222222222,211,2792,2581,1066.400000000000091,893.600492390195654,5332.000000000000000,5,211,1,20.0000000,211,1,20.0000000,724,2792
858,4.000000000000000,0.000277777777778,6268,9673,3405,7410.500000000000000,1341.837639209751842,29642.000000000000000,4,6268,1,25.0000000,6268,1,25.0000000,6576,9673
859,4.000000000000000,0.000277777777778,219,1005,786,688.750000000000000,291.350626393697667,2755.000000000000000,4,219,1,25.0000000,219,1,25.0000000,706,1005
860,3.000000000000000,0.000208333333333,36,1760,1724,929.666666666666629,705.243378006643979,2789.000000000000000,3,36,1,33.3333015,36,1,33.3333015,993,1760
861,4.000000000000000,0.000277777777778,359,824,465,616.750000000000000,184.221843167415955,2467.000000000000000,4,359,1,25.0000000,359,1,25.0000000,530,824
862,3.000000000000000,0.000208333333333,552,1230,678,903.000000000000000,277.312098546024515,2709.000000000000000,3,552,1,33.3333015,552,1,33.3333015,927,1230
863,4.000000000000000,0.000277777777778,1590,2287,697,1981.500000000000000,294.763040423998859,7926.000000000000000,4,1590,1,25.0000000,1590,1,25.0000000,1804,2287
864,4.000000000000000,0.000277777777778,1590,2287,697,1981.500000000000000,294.763040423998859,7926.000000000000000,4,1590,1,25.0000000,1590,1,25.0000000,1804,2287
865,4.000000000000000,0.000277777777778,593,6734,6141,2339.500000000000000,2551.825082171581926,9358.000000000000000,4,593,1,25.0000000,593,1,25.0000000,716,6734
866,3.000000000000000,0.000208333333333,142,2115,1973,899.666666666666742,868.053889776179517,2699.000000000000000,3,142,1,33.3333015,142,1,33.3333015,442,2115
867,5.000000000000000,0.000347222222222,145,682,537,371.600000000000023,182.339902380142803,1858.000000000000000,5,145,1,20.0000000,145,1,20.0000000,345,682
868,4.000000000000000,0.000277777777778,658,3456,2798,1375.750000000000000,1201.271487841112503,5503.000000000000000,4,658,1,25.0000000,658,1,25.0000000,668,3456
869,4.000000000000000,0.000277777777778,150,1943,1793,776.500000000000000,697.087691757643938,3106.000000000000000,4,150,1,25.0000000,150,1,25.0000000,357,1943
870,4.000000000000000,0.000277777777778,150,1943,1793,776.500000000000000,697.087691757643938,3106.000000000000000,4,150,1,25.0000000,150,1,25.0000000,357,1943
871,4.000000000000000,0.000277777777778,426,4836,4410,1785.250000000000000,1773.913945911695237,7141.000000000000000,4,426,1,25.0000000,426,1,25.0000000,909,4836
872,4.000000000000000,0.000277777777778,35,371,336,198.500000000000000,132.891873340697543,794.000000000000000,4,35,1,25.0000000,35,1,25.0000000,110,371
873,4.000000000000000,0.000277777777778,35,371,336,198.500000000000000,132.891873340697543,794.000000000000000,4,35,1,25.0000000,35,1,25.0000000,110,371
874,4.000000000000000,0.000277777777778,35,371,336,198.500000000000000,132.891873340697543,794.000000000000000,4,35,1,25.0000000,35,1,25.0000000,110,371
875,5.000000000000000,0.000347222222222,363,1503,1140,1035.799999999999955,374.826573230874374,5179.000000000000000,5,363,1,20.0000000,363,1,20.0000000,1056,1503
876,4.000000000000000,0.000277777777778,31,1022,991,468.500000000000000,355.190441875904071,1874.000000000000000,4,31,1,25.0000000,31,1,25.0000000,402,1022
877,3.000000000000000,0.000208333333333,649,1184,535,993.666666666666742,244.158873595770729,2981.000000000000000,3,649,1,33.3333015,649,1,33.3333015,1148,1184
878,4.000000000000000,0.000277777777778,511,2564,2053,1449.000000000000000,919.966575479783387,5796.000000000000000,4,511,1,25.0000000,511,1,25.0000000,571,2564
879,4.000000000000000,0.000277777777778,250,802,552,442.250000000000000,218.144877317804543,1769.000000000000000,4,250,1,25.0000000,250,1,25.0000000,288,802
880,4.000000000000000,0.000277777777778,147,1150,1003,779.750000000000000,378.253469911380989,3119.000000000000000,4,147,1,25.0000000,147,1,25.0000000,897,1150
881,4.000000000000000,0.000277777777778,614,1096,482,852.750000000000000,223.507690024303230,3411.000000000000000,4,614,1,25.0000000,614,1,25.0000000,646,1096
882,4.000000000000000,0.000277777777778,76,1349,1273,649.750000000000000,455.589384753420234,2599.000000000000000,4,76,1,25.0000000,76,1,25.0000000,541,1349
883,4.000000000000000,0.000277777777778,197,814,617,576.250000000000000,232.967138240568175,2305.000000000000000,4,197,1,25.0000000,197,1,25.0000000,589,814
884,4.000000000000000,0.000277777777778,175,814,639,443.749999999999943,269.858643552508795,1775.000000000000000,4,175,1,25.0000000,175,1,25.0000000,197,814
885,4.000000000000000,0.000277777777778,82,727,645,542.500000000000000,266.565657953157938,2170.000000000000000,4,82,1,25.0000000,82,1,25.0000000,676,727
886,5.000000000000000,0.000347222222222,245,1767,1522,949.200000000000045,513.793888636289694,4746.000000000000000,5,245,1,20.0000000,245,1,20.0000000,941,1767
887,4.000000000000000,0.000277777777778,93,7544,7451,2461.750000000000000,2968.366164660283175,9847.000000000000000,4,93,1,25.0000000,93,1,25.0000000,857,7544
888,4.000000000000000,0.000277777777778,93,7544,7451,2461.750000000000000,2968.366164660283175,9847.000000000000000,4,93,1,25.0000000,93,1,25.0000000,857,7544
889,4.000000000000000,0.000277777777778,334,869,535,596.500000000000000,251.591434671373491,2386.000000000000000,4,334,1,25.0000000,334,1,25.0000000,357,869
890,4.000000000000000,0.000277777777778,117,5779,5662,1996.250000000000227,2217.714969850724628,7985.000000000000000,4,117,1,25.0000000,117,1,25.0000000,943,5779
891,3.000000000000000,0.000208333333333,117,943,826,593.000000000000000,348.784556233022840,1779.000000000000000,3,117,1,33.3333015,117,1,33.3333015,719,943
892,4.000000000000000,0.000277777777778,117,943,826,633.000000000000000,309.899983865762749,2532.000000000000000,4,117,1,25.0000000,117,1,25.0000000,719,943
893,4.000000000000000,0.000277777777778,117,453,336,222.500000000000000,135.583000409343356,890.000000000000000,4,117,1,25.0000000,117,1,25.0000000,133,453
894,5.000000000000000,0.000347222222222,0,6781,6781,2166.199999999999818,2372.094888489918958,10831.000000000000000,5,0,1,20.0000000,0,1,20.0000000,1476,6781
895,4.000000000000000,0.000277777777778,1039,6781,5742,2707.750000000000000,2359.483139905856660,10831.000000000000000,4,1039,1,25.0000000,1039,1,25.0000000,1476,6781
896,4.000000000000000,0.000277777777778,1039,6781,5742,2707.750000000000000,2359.483139905856660,10831.000000000000000,4,1039,1,25.0000000,1039,1,25.0000000,1476,6781
897,3.000000000000000,0.000208333333333,580,2585,2005,1550.666666666666515,819.774901353346422,4652.000000000000000,3,580,1,33.3333015,580,1,33.3333015,1487,2585
898,4.000000000000000,0.000277777777778,117,1487,1370,656.250000000000000,508.203391861959119,2625.000000000000000,4,117,1,25.0000000,117,1,25.0000000,441,1487
899,4.000000000000000,0.000277777777778,146,656,510,499.250000000000000,207.958379249310354,1997.000000000000000,4,146,1,25.0000000,146,1,25.0000000,551,656
900,3.000000000000000,0.000208333333333,125,745,620,469.000000000000000,257.640576514388897,1407.000000000000000,3,125,1,33.3333015,125,1,33.3333015,537,745
901,4.000000000000000,0.000277777777778,459,1207,748,710.750000000000000,302.577572698308245,2843.000000000000000,4,459,1,25.0000000,459,1,25.0000000,473,1207
902,4.000000000000000,0.000277777777778,32,521,489,243.000000000000000,177.252644550088462,972.000000000000000,4,32,1,25.0000000,32,1,25.0000000,181,521
903,4.000000000000000,0.000277777777778,32,521,489,195.750000000000000,196.440035379756551,783.000000000000000,4,32,1,25.0000000,32,1,25.0000000,49,521
904,4.000000000000000,0.000277777777778,373,1862,1489,995.250000000000000,542.002940490178503,3981.000000000000000,4,373,1,25.0000000,373,1,25.0000000,815,1862
905,4.000000000000000,0.000277777777778,373,2095,1722,1442.000000000000000,660.603133507554617,5768.000000000000000,4,373,1,25.0000000,373,1,25.0000000,1438,2095
906,4.000000000000000,0.000277777777778,468,2779,2311,1393.500000000000000,919.641370317799442,5574.000000000000000,4,468,1,25.0000000,468,1,25.0000000,663,2779
907,6.000000000000000,0.000416666666667,257,817,560,534.500000000000000,175.952408338163991,3207.000000000000000,6,257,1,16.6667004,257,1,16.6667004,485,679
908,4.000000000000000,0.000277777777778,0,1395,1395,527.750000000000000,541.941129182866121,2111.000000000000000,4,0,1,25.0000000,0,1,25.0000000,150,1395
909,4.000000000000000,0.000277777777778,150,7510,7360,2405.250000000000000,2981.110143470046296,9621.000000000000000,4,150,1,25.0000000,150,1,25.0000000,566,7510
910,4.000000000000000,0.000277777777778,150,7510,7360,2405.250000000000000,2981.110143470046296,9621.000000000000000,4,150,1,25.0000000,150,1,25.0000000,566,7510
911,4.000000000000000,0.000277777777778,150,7510,7360,2405.250000000000000,2981.110143470046296,9621.000000000000000,4,150,1,25.0000000,150,1,25.0000000,566,7510
912,4.000000000000000,0.000277777777778,150,7510,7360,2405.250000000000000,2981.110143470046296,9621.000000000000000,4,150,1,25.0000000,150,1,25.0000000,566,7510
913,4.000000000000000,0.000277777777778,150,7510,7360,2405.250000000000000,2981.110143470046296,9621.000000000000000,4,150,1,25.0000000,150,1,25.0000000,566,7510
914,4.000000000000000,0.000277777777778,609,1950,1341,1355.500000000000000,535.889214297134345,5422.000000000000000,4,609,1,25.0000000,609,1,25.0000000,1095,1950
915,5.000000000000000,0.000347222222222,142,856,714,444.600000000000023,255.207836870265396,2223.000000000000000,5,142,1,20.0000000,142,1,20.0000000,378,856
916,3.000000000000000,0.000208333333333,1184,2208,1024,1831.000000000000000,459.578792664181435,5493.000000000000000,3,1184,1,33.3333015,1184,1,33.3333015,2101,2208
917,4.000000000000000,0.000277777777778,174,410,236,293.000000000000000,102.425582741813088,1172.000000000000000,4,174,1,25.0000000,174,1,25.0000000,210,410
918,3.000000000000000,0.000208333333333,85,929,844,367.333333333333371,397.160197177690804,1102.000000000000000,3,85,1,33.3333015,85,1,33.3333015,88,929
919,4.000000000000000,0.000277777777778,743,1545,802,1016.000000000000000,313.702087975199788,4064.000000000000000,4,743,1,25.0000000,743,1,25.0000000,831,1545
920,4.000000000000000,0.000277777777778,743,1545,802,1016.000000000000000,313.702087975199788,4064.000000000000000,4,743,1,25.0000000,743,1,25.0000000,831,1545
921,4.000000000000000,0.000277777777778,831,1805,974,1281.500000000000000,406.099433636640242,5126.000000000000000,4,831,1,25.0000000,831,1,25.0000000,945,1805
922,5.000000000000000,0.000347222222222,641,1492,851,982.399999999999977,278.642136081390277,4912.000000000000000,5,641,1,20.0000000,641,1,20.0000000,919,1492
923,4.000000000000000,0.000277777777778,274,4116,3842,1432.000000000000000,1558.377200808584803,5728.000000000000000,4,274,1,25.0000000,274,1,25.0000000,619,4116
924,4.000000000000000,0.000277777777778,792,1047,255,908.250000000000000,99.109472302096336,3633.000000000000000,4,792,1,25.0000000,792,1,25.0000000,841,1047
925,4.000000000000000,0.000277777777778,410,1851,1441,1145.000000000000000,576.333670715150902,4580.000000000000000,4,410,1,25.0000000,410,1,25.0000000,779,1851
926,4.000000000000000,0.000277777777778,232,3672,3440,2027.750000000000000,1590.494636111671980,8111.000000000000000,4,232,1,25.0000000,232,1,25.0000000,658,3672
927,4.000000000000000,0.000277777777778,803,2786,1983,1389.000000000000000,810.448949656916966,5556.000000000000000,4,803,1,25.0000000,803,1,25.0000000,942,2786
928,4.000000000000000,0.000277777777778,102,1307,1205,845.250000000000000,462.380457523888026,3381.000000000000000,4,102,1,25.0000000,102,1,25.0000000,828,1307
929,4.000000000000000,0.000277777777778,572,1022,450,766.500000000000000,176.756188010490888,3066.000000000000000,4,572,1,25.0000000,572,1,25.0000000,636,1022
930,4.000000000000000,0.000277777777778,15364,24273,8909,19031.750000000000000,3316.784691157989528,76127.000000000000000,4,15364,1,25.0000000,15364,1,25.0000000,17285,24273
931,6.000000000000000,0.000416666666667,114,3183,3069,1367.833333333333258,955.917607444397959,8207.000000000000000,6,114,1,16.6667004,114,1,16.6667004,1128,1664
932,3.000000000000000,0.000208333333333,696,1681,985,1040.666666666666742,453.225722521963235,3122.000000000000000,3,696,1,33.3333015,696,1,33.3333015,745,1681
933,4.000000000000000,0.000277777777778,228,16709,16481,8583.000000000000000,7764.481341338904713,34332.000000000000000,4,228,1,25.0000000,228,1,25.0000000,1442,16709
934,4.000000000000000,0.000277777777778,149,972,823,605.500000000000000,294.435476802643450,2422.000000000000000,4,149,1,25.0000000,149,1,25.0000000,649,972
935,4.000000000000000,0.000277777777778,1674,2759,1085,2362.500000000000000,440.334248043460718,9450.000000000000000,4,1674,1,25.0000000,1674,1,25.0000000,2283,2759
936,4.000000000000000,0.000277777777778,724,947,223,798.500000000000000,87.471423905181737,3194.000000000000000,4,724,1,25.0000000,724,1,25.0000000,750,947
937,4.000000000000000,0.000277777777778,753,1581,828,1050.500000000000000,315.987737103831307,4202.000000000000000,4,753,1,25.0000000,753,1,25.0000000,900,1581
938,4.000000000000000,0.000277777777778,93,7544,7451,2461.750000000000000,2968.366164660283175,9847.000000000000000,4,93,1,25.0000000,93,1,25.0000000,857,7544
939,3.000000000000000,0.000208333333333,93,1353,1260,631.333333333333371,530.476724800961961,1894.000000000000000,3,93,1,33.3333015,93,1,33.3333015,448,1353
940,4.000000000000000,0.000277777777778,728,973,245,821.250000000000000,92.623903502281749,3285.000000000000000,4,728,1,25.0000000,728,1,25.0000000,771,973
941,4.000000000000000,0.000277777777778,335,715,380,585.250000000000000,147.648865556088850,2341.000000000000000,4,335,1,25.0000000,335,1,25.0000000,630,715
942,3.000000000000000,0.000208333333333,104,630,526,356.333333333333371,215.267791883092031,1069.000000000000000,3,104,1,33.3333015,104,1,33.3333015,335,630
943,4.000000000000000,0.000277777777778,335,715,380,585.250000000000000,147.648865556088850,2341.000000000000000,4,335,1,25.0000000,335,1,25.0000000,630,715
944,4.000000000000000,0.000277777777778,67,1063,996,512.750000000000000,431.360855317215794,2051.000000000000000,4,67,1,25.0000000,67,1,25.0000000,116,1063
945,3.000000000000000,0.000208333333333,649,3416,2767,1679.000000000000000,1235.302661968582697,5037.000000000000000,3,649,1,33.3333015,649,1,33.3333015,972,3416
946,3.000000000000000,0.000208333333333,93,1353,1260,631.333333333333371,530.476724800961961,1894.000000000000000,3,93,1,33.3333015,93,1,33.3333015,448,1353
947,3.000000000000000,0.000208333333333,448,2857,2409,1552.666666666666742,993.552660350164274,4658.000000000000000,3,448,1,33.3333015,448,1,33.3333015,1353,2857
948,4.000000000000000,0.000277777777778,1353,7544,6191,3582.750000000000000,2355.925123491831073,14331.000000000000000,4,1353,1,25.0000000,1353,1,25.0000000,2577,7544
949,4.000000000000000,0.000277777777778,1353,7544,6191,3582.750000000000000,2355.925123491831073,14331.000000000000000,4,1353,1,25.0000000,1353,1,25.0000000,2577,7544
950,4.000000000000000,0.000277777777778,277,1036,759,752.250000000000000,297.691430007650752,3009.000000000000000,4,277,1,25.0000000,277,1,25.0000000,726,1036
951,4.000000000000000,0.000277777777778,157,737,580,362.500000000000000,235.267401056755006,1450.000000000000000,4,157,1,25.0000000,157,1,25.0000000,167,737
952,5.000000000000000,0.000347222222222,0,60,60,24.399999999999999,22.294393914165955,122.000000000000000,5,0,1,20.0000000,0,1,20.0000000,30,60
953,4.000000000000000,0.000277777777778,0,60,60,23.000000000000000,24.728526037756478,92.000000000000000,4,0,1,25.0000000,0,1,25.0000000,1,60
954,4.000000000000000,0.000277777777778,407,806,399,559.250000000000000,150.177187015871368,2237.000000000000000,4,407,1,25.0000000,407,1,25.0000000,483,806
955,4.000000000000000,0.000277777777778,490,3867,3377,1426.750000000000000,1414.420265515168694,5707.000000000000000,4,490,1,25.0000000,490,1,25.0000000,534,3867
956,4.000000000000000,0.000277777777778,211,894,683,444.250000000000000,267.370880052409575,1777.000000000000000,4,211,1,25.0000000,211,1,25.0000000,282,894
957,5.000000000000000,0.000347222222222,221,1171,950,720.000000000000000,418.645434705790137,3600.000000000000000,4,221,2,40.0000000,881,1,20.0000000,881,1171
958,4.000000000000000,0.000277777777778,142,856,714,476.500000000000000,259.072866197909661,1906.000000000000000,4,142,1,25.0000000,142,1,25.0000000,378,856
959,4.000000000000000,0.000277777777778,43,1903,1860,854.750000000000000,695.385639411686498,3419.000000000000000,4,43,1,25.0000000,43,1,25.0000000,464,1903
960,4.000000000000000,0.000277777777778,43,1903,1860,854.750000000000000,695.385639411686498,3419.000000000000000,4,43,1,25.0000000,43,1,25.0000000,464,1903
961,4.000000000000000,0.000277777777778,14,598,584,269.250000000000000,260.068620752292986,1077.000000000000000,4,14,1,25.0000000,14,1,25.0000000,15,598
962,5.000000000000000,0.000347222222222,0,1103,1103,439.600000000000023,465.709179638967441,2198.000000000000000,5,0,1,20.0000000,0,1,20.0000000,186,1103
963,5.000000000000000,0.000347222222222,0,1856,1856,807.799999999999955,668.202484281523652,4039.000000000000000,5,0,1,20.0000000,0,1,20.0000000,894,1856
964,4.000000000000000,0.000277777777778,0,1856,1856,746.000000000000000,780.369463779817579,2984.000000000000000,4,0,1,25.0000000,0,1,25.0000000,25,1856
965,4.000000000000000,0.000277777777778,292,1078,786,576.000000000000000,298.589182657376227,2304.000000000000000,4,292,1,25.0000000,292,1,25.0000000,457,1078
966,3.000000000000000,0.000208333333333,477,1078,601,808.666666666666629,249.284754625887388,2426.000000000000000,3,477,1,33.3333015,477,1,33.3333015,871,1078
967,5.000000000000000,0.000347222222222,1827,4036,2209,2607.199999999999818,776.884135505417703,13036.000000000000000,5,1827,1,20.0000000,1827,1,20.0000000,2317,4036
968,4.000000000000000,0.000277777777778,330,1716,1386,1002.000000000000000,491.505849405681033,4008.000000000000000,4,330,1,25.0000000,330,1,25.0000000,936,1716
969,4.000000000000000,0.000277777777778,33,1114,1081,651.000000000000000,390.213403152685146,2604.000000000000000,4,33,1,25.0000000,33,1,25.0000000,709,1114
970,4.000000000000000,0.000277777777778,669,1114,445,801.750000000000000,181.142726875798132,3207.000000000000000,4,669,1,25.0000000,669,1,25.0000000,709,1114
971,4.000000000000000,0.000277777777778,4,161,157,50.249999999999993,64.511142448417388,201.000000000000000,4,4,1,25.0000000,4,1,25.0000000,9,161
972,4.000000000000000,0.000277777777778,4,161,157,84.750000000000000,60.532532575467222,339.000000000000000,4,4,1,25.0000000,4,1,25.0000000,53,161
973,4.000000000000000,0.000277777777778,4,161,157,50.249999999999993,64.511142448417388,201.000000000000000,4,4,1,25.0000000,4,1,25.0000000,9,161
974,4.000000000000000,0.000277777777778,4,161,157,84.750000000000000,60.532532575467222,339.000000000000000,4,4,1,25.0000000,4,1,25.0000000,53,161
975,3.000000000000000,0.000208333333333,228,16709,16481,6126.333333333333940,7499.469951640286126,18379.000000000000000,3,228,1,33.3333015,228,1,33.3333015,1442,16709
976,4.000000000000000,0.000277777777778,239,713,474,496.750000000000000,169.547006756238545,1987.000000000000000,4,239,1,25.0000000,239,1,25.0000000,496,713
977,5.000000000000000,0.000347222222222,508,4160,3652,1341.600000000000136,1411.306146801607383,6708.000000000000000,5,508,1,20.0000000,508,1,20.0000000,697,4160
978,4.000000000000000,0.000277777777778,75,530,455,285.000000000000000,181.899697635812487,1140.000000000000000,4,75,1,25.0000000,75,1,25.0000000,150,530
979,4.000000000000000,0.000277777777778,131,2148,2017,789.250000000000000,794.513491074884087,3157.000000000000000,4,131,1,25.0000000,131,1,25.0000000,430,2148
980,4.000000000000000,0.000277777777778,186,1856,1670,1048.250000000000000,591.382437598547540,4193.000000000000000,4,186,1,25.0000000,186,1,25.0000000,1048,1856
981,4.000000000000000,0.000277777777778,140,653,513,431.000000000000000,186.138389377366224,1724.000000000000000,4,140,1,25.0000000,140,1,25.0000000,432,653
982,5.000000000000000,0.000347222222222,0,978,978,409.800000000000011,338.239205297079650,2049.000000000000000,5,0,1,20.0000000,0,1,20.0000000,432,978
983,4.000000000000000,0.000277777777778,0,978,978,477.250000000000000,346.784785565918412,1909.000000000000000,4,0,1,25.0000000,0,1,25.0000000,432,978
984,4.000000000000000,0.000277777777778,406,1294,888,818.750000000000000,367.499234693080666,3275.000000000000000,4,406,1,25.0000000,406,1,25.0000000,521,1294
985,4.000000000000000,0.000277777777778,132,777,645,464.750000000000000,248.533071240026317,1859.000000000000000,4,132,1,25.0000000,132,1,25.0000000,336,777
986,4.000000000000000,0.000277777777778,177,866,689,486.500000000000000,300.757792916492861,1946.000000000000000,4,177,1,25.0000000,177,1,25.0000000,207,866
987,4.000000000000000,0.000277777777778,177,866,689,486.500000000000000,300.757792916492861,1946.000000000000000,4,177,1,25.0000000,177,1,25.0000000,207,866
988,4.000000000000000,0.000277777777778,177,866,689,486.500000000000000,300.757792916492861,1946.000000000000000,4,177,1,25.0000000,177,1,25.0000000,207,866
989,4.000000000000000,0.000277777777778,75,1330,1255,710.250000000000000,506.750616674513765,2841.000000000000000,4,75,1,25.0000000,75,1,25.0000000,372,1330
990,4.000000000000000,0.000277777777778,737,1125,388,840.500000000000000,164.341869284732212,3362.000000000000000,3,750,2,50.0000000,737,1,25.0000000,750,1125
991,4.000000000000000,0.000277777777778,67,463,396,231.250000000000000,167.696712847926761,925.000000000000000,4,67,1,25.0000000,67,1,25.0000000,76,463
992,4.000000000000000,0.000277777777778,277,878,601,542.750000000000000,218.425473560205432,2171.000000000000000,4,277,1,25.0000000,277,1,25.0000000,456,878
993,4.000000000000000,0.000277777777778,348,2066,1718,1119.500000000000000,617.340465221582576,4478.000000000000000,4,348,1,25.0000000,348,1,25.0000000,937,2066
994,3.000000000000000,0.000208333333333,143,958,815,589.000000000000000,337.147840963970395,1767.000000000000000,3,143,1,33.3333015,143,1,33.3333015,666,958
995,4.000000000000000,0.000277777777778,90,2435,2345,790.500000000000000,966.910156115861696,3162.000000000000000,4,90,1,25.0000000,90,1,25.0000000,96,2435
996,4.000000000000000,0.000277777777778,130,1727,1597,677.500000000000000,618.328593872222655,2710.000000000000000,4,130,1,25.0000000,130,1,25.0000000,394,1727
997,4.000000000000000,0.000277777777778,130,1727,1597,677.500000000000000,618.328593872222655,2710.000000000000000,4,130,1,25.0000000,130,1,25.0000000,394,1727
998,5.000000000000000,0.000347222222222,261,4397,4136,1515.200000000000045,1512.370906887592810,7576.000000000000000,5,261,1,20.0000000,261,1,20.0000000,735,4397
999,4.000000000000000,0.000277777777778,83,597,514,342.500000000000000,249.141024321567727,1370.000000000000000,4,83,1,25.0000000,83,1,25.0000000,104,597
1000,4.000000000000000,0.000277777777778,83,597,514,342.500000000000000,249.141024321567727,1370.000000000000000,4,83,1,25.0000000,83,1,25.0000000,104,597
1001,4.000000000000000,0.000277777777778,83,597,514,342.500000000000000,249.141024321567727,1370.000000000000000,4,83,1,25.0000000,83,1,25.0000000,104,597
1002,4.000000000000000,0.000277777777778,83,597,514,342.500000000000000,249.141024321567727,1370.000000000000000,4,83,1,25.0000000,83,1,25.0000000,104,597
1003,4.000000000000000,0.000277777777778,83,597,514,342.500000000000000,249.141024321567727,1370.000000000000000,4,83,1,25.0000000,83,1,25.0000000,104,597
1004,4.000000000000000,0.000277777777778,83,597,514,342.500000000000000,249.141024321567727,1370.000000000000000,4,83,1,25.0000000,83,1,25.0000000,104,597
1005,4.000000000000000,0.000277777777778,83,597,514,342.500000000000000,249.141024321567727,1370.000000000000000,4,83,1,25.0000000,83,1,25.0000000,104,597
1006,4.000000000000000,0.000277777777778,708,7517,6809,4337.250000000000000,2426.256517250391425,17349.000000000000000,4,708,1,25.0000000,708,1,25.0000000,4276,7517
1007,4.000000000000000,0.000277777777778,388,1200,812,762.500000000000000,312.555195125596981,3050.000000000000000,4,388,1,25.0000000,388,1,25.0000000,562,1200
1008,4.000000000000000,0.000277777777778,369,1183,814,902.750000000000000,314.477642289559299,3611.000000000000000,4,369,1,25.0000000,369,1,25.0000000,1026,1183
1009,4.000000000000000,0.000277777777778,769,1384,615,980.250000000000000,242.459661593428763,3921.000000000000000,4,769,1,25.0000000,769,1,25.0000000,817,1384
1010,4.000000000000000,0.000277777777778,505,848,343,674.250000000000000,140.396536638194874,2697.000000000000000,4,505,1,25.0000000,505,1,25.0000000,572,848
1011,4.000000000000000,0.000277777777778,992,1769,777,1326.500000000000000,299.012123500034704,5306.000000000000000,4,992,1,25.0000000,992,1,25.0000000,1124,1769
1012,3.000000000000000,0.000208333333333,3405,12435,9030,7269.666666666666060,3799.475870286438749,21809.000000000000000,3,3405,1,33.3333015,3405,1,33.3333015,5969,12435
1013,5.000000000000000,0.000347222222222,3405,107167,103762,37867.400000000001455,40398.931934396481665,189337.000000000000000,5,3405,1,20.0000000,3405,1,20.0000000,12435,107167
1014,4.000000000000000,0.000277777777778,255,11859,11604,5868.500000000000000,5100.343003171453347,23474.000000000000000,4,255,1,25.0000000,255,1,25.0000000,1403,11859
1015,4.000000000000000,0.000277777777778,379,3316,2937,1263.250000000000000,1192.465801396417419,5053.000000000000000,4,379,1,25.0000000,379,1,25.0000000,610,3316
1016,4.000000000000000,0.000277777777778,379,3316,2937,1263.250000000000000,1192.465801396417419,5053.000000000000000,4,379,1,25.0000000,379,1,25.0000000,610,3316
1017,3.000000000000000,0.000208333333333,448,5305,4857,2649.666666666666970,2008.643378557334245,7949.000000000000000,3,448,1,33.3333015,448,1,33.3333015,2196,5305
1018,4.000000000000000,0.000277777777778,16,751,735,216.499999999999972,309.553307202491396,866.000000000000000,4,16,1,25.0000000,16,1,25.0000000,21,751
1019,4.000000000000000,0.000277777777778,1025,1878,853,1368.750000000000000,316.732043689930435,5475.000000000000000,4,1025,1,25.0000000,1025,1,25.0000000,1215,1878
1020,5.000000000000000,0.000347222222222,237,598,361,427.399999999999977,122.295707201847435,2137.000000000000000,5,237,1,20.0000000,237,1,20.0000000,423,598
1021,4.000000000000000,0.000277777777778,314,6965,6651,2700.000000000000000,2534.889642568291492,10800.000000000000000,4,314,1,25.0000000,314,1,25.0000000,1596,6965
1022,4.000000000000000,0.000277777777778,1076,2520,1444,1809.500000000000000,670.277740940276317,7238.000000000000000,4,1076,1,25.0000000,1076,1,25.0000000,1207,2520
1023,4.000000000000000,0.000277777777778,0,60,60,22.750000000000000,24.651318423159438,91.000000000000000,4,0,1,25.0000000,0,1,25.0000000,1,60
1024,4.000000000000000,0.000277777777778,0,60,60,34.750000000000000,22.752747086890409,139.000000000000000,4,0,1,25.0000000,0,1,25.0000000,30,60
1025,4.000000000000000,0.000277777777778,0,60,60,34.750000000000000,22.752747086890409,139.000000000000000,4,0,1,25.0000000,0,1,25.0000000,30,60
1026,4.000000000000000,0.000277777777778,0,60,60,34.750000000000000,22.752747086890409,139.000000000000000,4,0,1,25.0000000,0,1,25.0000000,30,60
1027,4.000000000000000,0.000277777777778,0,60,60,34.750000000000000,22.752747086890409,139.000000000000000,4,0,1,25.0000000,0,1,25.0000000,30,60
1028,4.000000000000000,0.000277777777778,711,8404,7693,2768.750000000000000,3255.403152836834579,11075.000000000000000,4,711,1,25.0000000,711,1,25.0000000,958,8404
1029,4.000000000000000,0.000277777777778,1204,1741,537,1495.000000000000000,191.330865257020150,5980.000000000000000,4,1204,1,25.0000000,1204,1,25.0000000,1507,1741
1030,4.000000000000000,0.000277777777778,1143,2538,1395,1815.250000000000000,540.890642829028820,7261.000000000000000,4,1143,1,25.0000000,1143,1,25.0000000,1478,2538
1031,4.000000000000000,0.000277777777778,1071,1902,831,1501.500000000000000,294.185740646959289,6006.000000000000000,4,1071,1,25.0000000,1071,1,25.0000000,1516,1902
1032,4.000000000000000,0.000277777777778,66,1467,1401,703.000000000000000,499.635367042806536,2812.000000000000000,4,66,1,25.0000000,66,1,25.0000000,617,1467
1033,4.000000000000000,0.000277777777778,450,921,471,675.750000000000000,179.563881390439974,2703.000000000000000,4,450,1,25.0000000,450,1,25.0000000,572,921
1034,4.000000000000000,0.000277777777778,298,1226,928,911.500000000000000,374.463282579213683,3646.000000000000000,4,298,1,25.0000000,298,1,25.0000000,918,1226
1035,4.000000000000000,0.000277777777778,0,1856,1856,746.000000000000000,780.369463779817579,2984.000000000000000,4,0,1,25.0000000,0,1,25.0000000,25,1856
1036,4.000000000000000,0.000277777777778,0,1856,1856,746.000000000000000,780.369463779817579,2984.000000000000000,4,0,1,25.0000000,0,1,25.0000000,25,1856
1037,4.000000000000000,0.000277777777778,197,814,617,576.250000000000000,232.967138240568175,2305.000000000000000,4,197,1,25.0000000,197,1,25.0000000,589,814
1038,4.000000000000000,0.000277777777778,218,876,658,478.000000000000000,252.162645925204401,1912.000000000000000,4,218,1,25.0000000,218,1,25.0000000,312,876
1039,5.000000000000000,0.000347222222222,104,876,772,403.199999999999989,270.645450728439187,2016.000000000000000,5,104,1,20.0000000,104,1,20.0000000,312,876
1040,3.000000000000000,0.000208333333333,312,876,564,564.666666666666629,233.959160728723987,1694.000000000000000,3,312,1,33.3333015,312,1,33.3333015,506,876
1041,4.000000000000000,0.000277777777778,80,2692,2612,875.000000000000000,1058.091205898621865,3500.000000000000000,4,80,1,25.0000000,80,1,25.0000000,258,2692
1042,5.000000000000000,0.000347222222222,28,451,423,230.599999999999994,157.858924359695294,1153.000000000000000,5,28,1,20.0000000,28,1,20.0000000,154,451
1043,4.000000000000000,0.000277777777778,179,871,692,514.000000000000000,284.590056045533686,2056.000000000000000,4,179,1,25.0000000,179,1,25.0000000,298,871
1044,4.000000000000000,0.000277777777778,615,1686,1071,1084.250000000000000,420.487440359400011,4337.000000000000000,4,615,1,25.0000000,615,1,25.0000000,777,1686
1045,4.000000000000000,0.000277777777778,615,1686,1071,963.500000000000000,422.314160311964940,3854.000000000000000,4,615,1,25.0000000,615,1,25.0000000,776,1686
1046,4.000000000000000,0.000277777777778,179,1072,893,528.250000000000000,363.959733349720977,2113.000000000000000,4,179,1,25.0000000,179,1,25.0000000,215,1072
1047,4.000000000000000,0.000277777777778,136,2478,2342,919.750000000000000,927.784019855914494,3679.000000000000000,4,136,1,25.0000000,136,1,25.0000000,308,2478
1048,4.000000000000000,0.000277777777778,373,1031,658,709.250000000000000,256.815473638174694,2837.000000000000000,4,373,1,25.0000000,373,1,25.0000000,563,1031
1049,4.000000000000000,0.000277777777778,3086,11060,7974,6287.000000000000000,3273.307959847346865,25148.000000000000000,4,3086,1,25.0000000,3086,1,25.0000000,3428,11060
1050,4.000000000000000,0.000277777777778,580,962,382,714.750000000000000,146.528794098634393,2859.000000000000000,4,580,1,25.0000000,580,1,25.0000000,647,962
1051,4.000000000000000,0.000277777777778,230,826,596,619.000000000000000,240.381987677945631,2476.000000000000000,4,230,1,25.0000000,230,1,25.0000000,609,826
1052,4.000000000000000,0.000277777777778,480,3060,2580,1745.500000000000000,1199.479366225196827,6982.000000000000000,4,480,1,25.0000000,480,1,25.0000000,620,3060
1053,4.000000000000000,0.000277777777778,609,1730,1121,946.750000000000000,454.640173653846830,3787.000000000000000,3,724,2,50.0000000,609,1,25.0000000,724,1730
1054,5.000000000000000,0.000347222222222,1093,1486,393,1340.400000000000091,135.561941561782021,6702.000000000000000,5,1093,1,20.0000000,1093,1,20.0000000,1363,1486
1055,4.000000000000000,0.000277777777778,49,3762,3713,1031.000000000000000,1577.365683663746950,4124.000000000000000,4,49,1,25.0000000,49,1,25.0000000,148,3762
1056,4.000000000000000,0.000277777777778,575,1150,575,911.500000000000000,210.616357389448751,3646.000000000000000,4,575,1,25.0000000,575,1,25.0000000,925,1150
1057,5.000000000000000,0.000347222222222,504,1995,1491,1184.000000000000000,546.946798144024228,5920.000000000000000,5,504,1,20.0000000,504,1,20.0000000,996,1995
1058,4.000000000000000,0.000277777777778,66,1187,1121,542.250000000000000,477.018015907156268,2169.000000000000000,4,66,1,25.0000000,66,1,25.0000000,102,1187
1059,5.000000000000000,0.000347222222222,32,814,782,250.400000000000006,290.352613213657833,1252.000000000000000,5,32,1,20.0000000,32,1,20.0000000,102,814
1060,4.000000000000000,0.000277777777778,66,814,748,305.000000000000000,300.790624853900681,1220.000000000000000,4,66,1,25.0000000,66,1,25.0000000,102,814
1061,4.000000000000000,0.000277777777778,379,690,311,517.750000000000000,123.220077503627635,2071.000000000000000,4,379,1,25.0000000,379,1,25.0000000,426,690
1062,4.000000000000000,0.000277777777778,16,641,625,334.000000000000000,252.460888059913174,1336.000000000000000,4,16,1,25.0000000,16,1,25.0000000,167,641
1063,4.000000000000000,0.000277777777778,17,289,272,131.250000000000000,100.494713791323377,525.000000000000000,4,17,1,25.0000000,17,1,25.0000000,82,289
1064,4.000000000000000,0.000277777777778,647,962,315,740.250000000000000,128.643645393000270,2961.000000000000000,4,647,1,25.0000000,647,1,25.0000000,670,962
1065,4.000000000000000,0.000277777777778,302,937,635,733.750000000000000,251.906108500766607,2935.000000000000000,4,302,1,25.0000000,302,1,25.0000000,847,937
1066,4.000000000000000,0.000277777777778,1,126,125,41.000000000000000,49.603427300943629,164.000000000000000,4,1,1,25.0000000,1,1,25.0000000,17,126
1067,4.000000000000000,0.000277777777778,1,126,125,41.000000000000000,49.603427300943629,164.000000000000000,4,1,1,25.0000000,1,1,25.0000000,17,126
1068,4.000000000000000,0.000277777777778,143,958,815,565.500000000000000,294.802052231662685,2262.000000000000000,4,143,1,25.0000000,143,1,25.0000000,495,958
1069,4.000000000000000,0.000277777777778,654,748,94,694.500000000000000,38.874799034850319,2778.000000000000000,4,654,1,25.0000000,654,1,25.0000000,661,748
1070,3.000000000000000,0.000208333333333,47,10048,10001,4022.666666666666515,4332.501227800044035,12068.000000000000000,3,47,1,33.3333015,47,1,33.3333015,1973,10048
1071,4.000000000000000,0.000277777777778,716,977,261,797.000000000000000,105.714237451726447,3188.000000000000000,4,716,1,25.0000000,716,1,25.0000000,727,977
1072,4.000000000000000,0.000277777777778,6,1847,1841,563.250000000000000,748.226361136788569,2253.000000000000000,4,6,1,25.0000000,6,1,25.0000000,108,1847
1073,4.000000000000000,0.000277777777778,636,1064,428,868.000000000000000,192.353840616713455,3472.000000000000000,4,636,1,25.0000000,636,1,25.0000000,720,1064
1074,4.000000000000000,0.000277777777778,636,2459,1823,1302.750000000000000,689.446653121182408,5211.000000000000000,4,636,1,25.0000000,636,1,25.0000000,1052,2459
1075,4.000000000000000,0.000277777777778,1735,3865,2130,2987.500000000000000,785.206501501356684,11950.000000000000000,4,1735,1,25.0000000,1735,1,25.0000000,3006,3865
1076,4.000000000000000,0.000277777777778,60,1692,1632,802.250000000000000,611.455793577916779,3209.000000000000000,4,60,1,25.0000000,60,1,25.0000000,462,1692
1077,4.000000000000000,0.000277777777778,0,3,3,1.000000000000000,1.224744871391589,4.000000000000000,3,0,2,50.0000000,1,1,25.0000000,0,3
1078,4.000000000000000,0.000277777777778,25,677,652,353.250000000000000,276.338899722786039,1413.000000000000000,4,25,1,25.0000000,25,1,25.0000000,140,677
1079,3.000000000000000,0.000208333333333,897,3867,2970,1972.666666666666515,1343.598733087954315,5918.000000000000000,3,897,1,33.3333015,897,1,33.3333015,1154,3867
1080,4.000000000000000,0.000277777777778,364,1024,660,648.750000000000000,259.853203751656679,2595.000000000000000,4,364,1,25.0000000,364,1,25.0000000,455,1024
1081,4.000000000000000,0.000277777777778,127,2975,2848,1160.250000000000000,1085.734630331003018,4641.000000000000000,4,127,1,25.0000000,127,1,25.0000000,613,2975
1082,4.000000000000000,0.000277777777778,6,23388,23382,6718.750000000000000,9650.304901271254494,26875.000000000000000,4,6,1,25.0000000,6,1,25.0000000,1634,23388
1083,3.000000000000000,0.000208333333333,500,774,274,648.333333333333371,113.002458183685349,1945.000000000000000,3,500,1,33.3333015,500,1,33.3333015,671,774
1084,4.000000000000000,0.000277777777778,330,1598,1268,1019.000000000000000,541.726406962038368,4076.000000000000000,4,330,1,25.0000000,330,1,25.0000000,651,1598
1085,4.000000000000000,0.000277777777778,330,1598,1268,1019.000000000000000,541.726406962038368,4076.000000000000000,4,330,1,25.0000000,330,1,25.0000000,651,1598
1086,4.000000000000000,0.000277777777778,12,1598,1586,647.750000000000000,593.323004357660125,2591.000000000000000,4,12,1,25.0000000,12,1,25.0000000,330,1598
1087,4.000000000000000,0.000277777777778,330,1598,1268,1019.000000000000000,541.726406962038368,4076.000000000000000,4,330,1,25.0000000,330,1,25.0000000,651,1598
1088,4.000000000000000,0.000277777777778,330,1598,1268,1019.000000000000000,541.726406962038368,4076.000000000000000,4,330,1,25.0000000,330,1,25.0000000,651,1598
1089,5.000000000000000,0.000347222222222,12,1598,1586,637.799999999999955,531.057209724150198,3189.000000000000000,5,12,1,20.0000000,12,1,20.0000000,598,1598
1090,3.000000000000000,0.000208333333333,880,2171,1291,1352.666666666666742,580.967201216117587,4058.000000000000000,3,880,1,33.3333015,880,1,33.3333015,1007,2171
1091,4.000000000000000,0.000277777777778,492,2171,1679,1137.500000000000000,626.124787881776797,4550.000000000000000,4,492,1,25.0000000,492,1,25.0000000,880,2171
1092,4.000000000000000,0.000277777777778,616,990,374,771.750000000000000,137.572480896435110,3087.000000000000000,4,616,1,25.0000000,616,1,25.0000000,710,990
1093,4.000000000000000,0.000277777777778,590,1386,796,920.000000000000000,300.163288894561560,3680.000000000000000,4,590,1,25.0000000,590,1,25.0000000,740,1386
1094,4.000000000000000,0.000277777777778,542,964,422,731.250000000000000,180.176822871311600,2925.000000000000000,4,542,1,25.0000000,542,1,25.0000000,570,964
1095,4.000000000000000,0.000277777777778,294,4941,4647,1692.500000000000227,1898.198158781111260,6770.000000000000000,4,294,1,25.0000000,294,1,25.0000000,457,4941
1096,4.000000000000000,0.000277777777778,607,1521,914,1115.250000000000000,386.700384664923774,4461.000000000000000,4,607,1,25.0000000,607,1,25.0000000,875,1521
1097,4.000000000000000,0.000277777777778,235,1009,774,605.250000000000000,343.854893087185815,2421.000000000000000,4,235,1,25.0000000,235,1,25.0000000,295,1009
1098,4.000000000000000,0.000277777777778,275,1358,1083,729.750000000000000,401.968515558121794,2919.000000000000000,4,275,1,25.0000000,275,1,25.0000000,521,1358
1099,5.000000000000000,0.000347222222222,275,1358,1083,895.200000000000045,427.419887230344045,4476.000000000000000,5,275,1,20.0000000,275,1,20.0000000,1032,1358
1100,5.000000000000000,0.000347222222222,275,1358,1083,895.200000000000045,427.419887230344045,4476.000000000000000,5,275,1,20.0000000,275,1,20.0000000,1032,1358
1101,5.000000000000000,0.000347222222222,231,967,736,472.999999999999943,269.054641290574978,2365.000000000000000,5,231,1,20.0000000,231,1,20.0000000,423,967
1102,4.000000000000000,0.000277777777778,231,507,276,349.500000000000000,119.275940574786503,1398.000000000000000,4,231,1,25.0000000,231,1,25.0000000,237,507
1103,4.000000000000000,0.000277777777778,65,1029,964,615.750000000000000,348.986658054430507,2463.000000000000000,4,65,1,25.0000000,65,1,25.0000000,642,1029
1104,5.000000000000000,0.000347222222222,607,1856,1249,1191.599999999999909,403.654604829425921,5958.000000000000000,5,607,1,20.0000000,607,1,20.0000000,1157,1856
1105,4.000000000000000,0.000277777777778,29,1077,1048,423.750000000000000,393.463705441810760,1695.000000000000000,4,29,1,25.0000000,29,1,25.0000000,254,1077
1106,5.000000000000000,0.000347222222222,113,556,443,247.599999999999994,172.511564829723824,1238.000000000000000,5,113,1,20.0000000,113,1,20.0000000,128,556
1107,4.000000000000000,0.000277777777778,26,794,768,349.500000000000000,317.358236067696851,1398.000000000000000,4,26,1,25.0000000,26,1,25.0000000,73,794
1108,4.000000000000000,0.000277777777778,3,436,433,126.500000000000000,179.140308138620753,506.000000000000000,4,3,1,25.0000000,3,1,25.0000000,30,436
1109,4.000000000000000,0.000277777777778,693,914,221,761.250000000000000,89.107729743271975,3045.000000000000000,4,693,1,25.0000000,693,1,25.0000000,709,914
1110,5.000000000000000,0.000347222222222,217,1261,1044,877.200000000000045,379.834911507618017,4386.000000000000000,5,217,1,20.0000000,217,1,20.0000000,1065,1261
1111,4.000000000000000,0.000277777777778,664,1273,609,879.000000000000000,235.103168842957103,3516.000000000000000,4,664,1,25.0000000,664,1,25.0000000,747,1273
1112,4.000000000000000,0.000277777777778,3,181,178,79.500000000000000,68.769542676972918,318.000000000000000,4,3,1,25.0000000,3,1,25.0000000,32,181
1113,4.000000000000000,0.000277777777778,3,102,99,50.750000000000000,37.049797570297201,203.000000000000000,4,3,1,25.0000000,3,1,25.0000000,32,102
1114,3.000000000000000,0.000208333333333,391,1394,1003,883.666666666666629,409.663547587800679,2651.000000000000000,3,391,1,33.3333015,391,1,33.3333015,866,1394
1115,4.000000000000000,0.000277777777778,120,2692,2572,1439.500000000000000,1241.305059201806444,5758.000000000000000,4,120,1,25.0000000,120,1,25.0000000,279,2692
1116,4.000000000000000,0.000277777777778,120,2692,2572,1439.500000000000000,1241.305059201806444,5758.000000000000000,4,120,1,25.0000000,120,1,25.0000000,279,2692
1117,4.000000000000000,0.000277777777778,149,820,671,489.250000000000000,327.876024588563041,1957.000000000000000,4,149,1,25.0000000,149,1,25.0000000,174,820
1118,4.000000000000000,0.000277777777778,149,820,671,489.250000000000000,327.876024588563041,1957.000000000000000,4,149,1,25.0000000,149,1,25.0000000,174,820
1119,5.000000000000000,0.000347222222222,0,820,820,245.599999999999994,293.429787172331942,1228.000000000000000,5,0,1,20.0000000,0,1,20.0000000,149,820
1120,4.000000000000000,0.000277777777778,944,7120,6176,3307.250000000000000,2406.581743365473358,13229.000000000000000,4,944,1,25.0000000,944,1,25.0000000,1584,7120
1121,4.000000000000000,0.000277777777778,741,1626,885,1098.250000000000000,346.356301371867630,4393.000000000000000,4,741,1,25.0000000,741,1,25.0000000,841,1626
1122,4.000000000000000,0.000277777777778,630,2572,1942,1298.500000000000000,754.019064745713194,5194.000000000000000,4,630,1,25.0000000,630,1,25.0000000,890,2572
1123,4.000000000000000,0.000277777777778,959,1544,585,1220.250000000000000,242.320423200356771,4881.000000000000000,4,959,1,25.0000000,959,1,25.0000000,1016,1544
1124,5.000000000000000,0.000347222222222,150,1943,1793,984.000000000000000,761.596481084307470,4920.000000000000000,5,150,1,20.0000000,150,1,20.0000000,656,1943
1125,4.000000000000000,0.000277777777778,317,2456,2139,1059.500000000000000,827.819575753074332,4238.000000000000000,4,317,1,25.0000000,317,1,25.0000000,619,2456
1126,4.000000000000000,0.000277777777778,317,2456,2139,1059.500000000000000,827.819575753074332,4238.000000000000000,4,317,1,25.0000000,317,1,25.0000000,619,2456
1127,4.000000000000000,0.000277777777778,304,1212,908,882.500000000000000,359.264178565022007,3530.000000000000000,4,304,1,25.0000000,304,1,25.0000000,862,1212
1128,5.000000000000000,0.000347222222222,1,211,210,54.200000000000003,79.371027459646768,271.000000000000000,5,1,1,20.0000000,1,1,20.0000000,11,211
1129,4.000000000000000,0.000277777777778,0,982,982,484.500000000000000,482.127835744836432,1938.000000000000000,4,0,1,25.0000000,0,1,25.0000000,5,982
1130,5.000000000000000,0.000347222222222,637,1316,679,1058.599999999999909,232.021205927389303,5293.000000000000000,5,637,1,20.0000000,637,1,20.0000000,1103,1316
1131,3.000000000000000,0.000208333333333,994,1034,40,1009.333333333333371,17.613126418163880,3028.000000000000000,3,994,1,33.3333015,994,1,33.3333015,1000,1034
1132,4.000000000000000,0.000277777777778,235,517,282,349.500000000000000,113.522024294847739,1398.000000000000000,4,235,1,25.0000000,235,1,25.0000000,256,517
1133,4.000000000000000,0.000277777777778,1676,4206,2530,2556.000000000000000,979.433254489554315,10224.000000000000000,4,1676,1,25.0000000,1676,1,25.0000000,2023,4206
1134,4.000000000000000,0.000277777777778,1676,4206,2530,2556.000000000000000,979.433254489554315,10224.000000000000000,4,1676,1,25.0000000,1676,1,25.0000000,2023,4206
1135,4.000000000000000,0.000277777777778,1676,4206,2530,2556.000000000000000,979.433254489554315,10224.000000000000000,4,1676,1,25.0000000,1676,1,25.0000000,2023,4206
1136,4.000000000000000,0.000277777777778,0,2009,2009,1360.000000000000000,798.768114035606686,5440.000000000000000,4,0,1,25.0000000,0,1,25.0000000,1596,2009
1137,4.000000000000000,0.000277777777778,143,958,815,565.500000000000000,294.802052231662685,2262.000000000000000,4,143,1,25.0000000,143,1,25.0000000,495,958
1138,5.000000000000000,0.000347222222222,249,1174,925,586.200000000000045,315.444067942321624,2931.000000000000000,5,249,1,20.0000000,249,1,20.0000000,520,1174
1139,4.000000000000000,0.000277777777778,139,2383,2244,1075.750000000000000,847.960899747152212,4303.000000000000000,4,139,1,25.0000000,139,1,25.0000000,558,2383
1140,4.000000000000000,0.000277777777778,1191,2667,1476,2063.500000000000000,546.564497566389832,8254.000000000000000,4,1191,1,25.0000000,1191,1,25.0000000,2069,2667
1141,5.000000000000000,0.000347222222222,293,1130,837,873.199999999999932,296.658996155518651,4366.000000000000000,5,293,1,20.0000000,293,1,20.0000000,981,1130
1142,4.000000000000000,0.000277777777778,1159,2502,1343,1720.750000000000000,519.139371941678064,6883.000000000000000,4,1159,1,25.0000000,1159,1,25.0000000,1358,2502
1143,4.000000000000000,0.000277777777778,113,481,368,260.500000000000000,151.222518164458563,1042.000000000000000,4,113,1,25.0000000,113,1,25.0000000,128,481
1144,4.000000000000000,0.000277777777778,5630,11368,5738,8190.250000000000000,2112.487204103258136,32761.000000000000000,4,5630,1,25.0000000,5630,1,25.0000000,7172,11368
1145,4.000000000000000,0.000277777777778,0,464,464,138.750000000000000,191.305220786051734,555.000000000000000,4,0,1,25.0000000,0,1,25.0000000,1,464
1146,5.000000000000000,0.000347222222222,953,5464,4511,2147.400000000000091,1686.914651071594790,10737.000000000000000,5,953,1,20.0000000,953,1,20.0000000,1306,5464
1147,4.000000000000000,0.000277777777778,875,2043,1168,1652.000000000000000,455.984100600009981,6608.000000000000000,4,875,1,25.0000000,875,1,25.0000000,1828,2043
1148,4.000000000000000,0.000277777777778,3338,13303,9965,8109.500000000000000,3565.750587183573771,32438.000000000000000,4,3338,1,25.0000000,3338,1,25.0000000,7181,13303
1149,5.000000000000000,0.000347222222222,3,1682,1679,754.399999999999977,609.849358448461430,3772.000000000000000,5,3,1,20.0000000,3,1,20.0000000,660,1682
1150,5.000000000000000,0.000347222222222,0,6781,6781,2166.199999999999818,2372.094888489918958,10831.000000000000000,5,0,1,20.0000000,0,1,20.0000000,1476,6781
1151,3.000000000000000,0.000208333333333,211,473,262,298.333333333333314,123.507984447250308,895.000000000000000,2,211,2,66.6667023,473,1,33.3333015,211,473
1152,3.000000000000000,0.000208333333333,871,7238,6367,3062.333333333333030,2953.851308978763427,9187.000000000000000,3,871,1,33.3333015,871,1,33.3333015,1078,7238
1153,5.000000000000000,0.000347222222222,490,7238,6748,2083.599999999999909,2584.244771688625860,10418.000000000000000,5,490,1,20.0000000,490,1,20.0000000,871,7238
1154,4.000000000000000,0.000277777777778,79,3598,3519,1119.750000000000000,1437.513021680151496,4479.000000000000000,4,79,1,25.0000000,79,1,25.0000000,339,3598
1155,4.000000000000000,0.000277777777778,48,375,327,211.500000000000000,115.625472972005610,846.000000000000000,4,48,1,25.0000000,48,1,25.0000000,209,375
1156,4.000000000000000,0.000277777777778,530,3493,2963,1552.500000000000000,1143.789862693318128,6210.000000000000000,4,530,1,25.0000000,530,1,25.0000000,1076,3493
1157,4.000000000000000,0.000277777777778,530,3493,2963,1552.500000000000000,1143.789862693318128,6210.000000000000000,4,530,1,25.0000000,530,1,25.0000000,1076,3493
1158,4.000000000000000,0.000277777777778,598,2289,1691,1098.250000000000000,690.467368888639044,4393.000000000000000,4,598,1,25.0000000,598,1,25.0000000,738,2289
1159,4.000000000000000,0.000277777777778,78,562,484,359.750000000000000,199.767833997368058,1439.000000000000000,4,78,1,25.0000000,78,1,25.0000000,265,562
1160,4.000000000000000,0.000277777777778,588,1188,600,832.000000000000000,242.776646323323291,3328.000000000000000,4,588,1,25.0000000,588,1,25.0000000,629,1188
1161,3.000000000000000,0.000208333333333,296,1144,848,798.666666666666629,363.631070668549398,2396.000000000000000,3,296,1,33.3333015,296,1,33.3333015,956,1144
1162,4.000000000000000,0.000277777777778,522,3188,2666,1292.500000000000000,1098.118049209646642,5170.000000000000000,4,522,1,25.0000000,522,1,25.0000000,685,3188
1163,4.000000000000000,0.000277777777778,427,3595,3168,1613.000000000000000,1189.004625726914583,6452.000000000000000,4,427,1,25.0000000,427,1,25.0000000,1175,3595
1164,5.000000000000000,0.000347222222222,464,1562,1098,802.200000000000045,402.650419098254531,4011.000000000000000,4,464,2,40.0000000,737,1,20.0000000,737,1562
1165,4.000000000000000,0.000277777777778,496,1092,596,671.500000000000000,244.000512294544166,2686.000000000000000,4,496,1,25.0000000,496,1,25.0000000,533,1092
1166,3.000000000000000,0.000208333333333,590,2725,2135,1366.000000000000000,964.182901044540699,4098.000000000000000,3,590,1,33.3333015,590,1,33.3333015,783,2725
1167,4.000000000000000,0.000277777777778,912,5463,4551,2601.500000000000000,1877.725019804550584,10406.000000000000000,4,912,1,25.0000000,912,1,25.0000000,926,5463
1168,6.000000000000000,0.000416666666667,9,1004,995,287.000000000000000,359.772613373132288,1722.000000000000000,6,9,1,16.6667004,9,1,16.6667004,58,495
1169,4.000000000000000,0.000277777777778,452,2479,2027,1050.500000000000000,837.282061195628444,4202.000000000000000,4,452,1,25.0000000,452,1,25.0000000,461,2479
1170,4.000000000000000,0.000277777777778,275,1290,1015,779.500000000000000,401.780101548098060,3118.000000000000000,4,275,1,25.0000000,275,1,25.0000000,521,1290
1171,4.000000000000000,0.000277777777778,293,1130,837,855.250000000000000,329.237281455183961,3421.000000000000000,4,293,1,25.0000000,293,1,25.0000000,981,1130
1172,4.000000000000000,0.000277777777778,1179,3867,2688,3012.500000000000000,1070.541335026350225,12050.000000000000000,4,1179,1,25.0000000,1179,1,25.0000000,3421,3867
1173,4.000000000000000,0.000277777777778,375,630,255,476.750000000000000,94.027589036409950,1907.000000000000000,4,375,1,25.0000000,375,1,25.0000000,441,630
1174,4.000000000000000,0.000277777777778,521,2990,2469,1408.500000000000000,962.476103599460771,5634.000000000000000,4,521,1,25.0000000,521,1,25.0000000,765,2990
1175,4.000000000000000,0.000277777777778,765,2990,2225,1688.000000000000000,815.235242123400894,6752.000000000000000,4,765,1,25.0000000,765,1,25.0000000,1358,2990
1176,4.000000000000000,0.000277777777778,765,2990,2225,1688.000000000000000,815.235242123400894,6752.000000000000000,4,765,1,25.0000000,765,1,25.0000000,1358,2990
1177,4.000000000000000,0.000277777777778,658,1295,637,1033.250000000000000,253.029025014917949,4133.000000000000000,4,658,1,25.0000000,658,1,25.0000000,948,1295
1178,4.000000000000000,0.000277777777778,231,510,279,371.250000000000000,137.270490273765688,1485.000000000000000,4,231,1,25.0000000,231,1,25.0000000,237,510
1179,5.000000000000000,0.000347222222222,219,2204,1985,1284.599999999999909,651.773150720402100,6423.000000000000000,5,219,1,20.0000000,219,1,20.0000000,1285,2204
1180,4.000000000000000,0.000277777777778,219,1615,1396,1054.750000000000000,516.580281756863087,4219.000000000000000,4,219,1,25.0000000,219,1,25.0000000,1100,1615
1181,5.000000000000000,0.000347222222222,219,2204,1985,1284.599999999999909,651.773150720402100,6423.000000000000000,5,219,1,20.0000000,219,1,20.0000000,1285,2204
1182,4.000000000000000,0.000277777777778,502,2061,1559,1037.750000000000000,603.029590899153163,4151.000000000000000,4,502,1,25.0000000,502,1,25.0000000,765,2061
1183,5.000000000000000,0.000347222222222,4,598,594,128.599999999999994,234.731847008453457,643.000000000000000,5,4,1,20.0000000,4,1,20.0000000,14,598
1184,4.000000000000000,0.000277777777778,12,598,586,159.750000000000000,253.026060910729115,639.000000000000000,4,12,1,25.0000000,12,1,25.0000000,14,598
1185,4.000000000000000,0.000277777777778,14,598,584,269.250000000000000,260.068620752292986,1077.000000000000000,4,14,1,25.0000000,14,1,25.0000000,15,598
1186,4.000000000000000,0.000277777777778,364,1262,898,882.000000000000000,362.076649343754298,3528.000000000000000,4,364,1,25.0000000,364,1,25.0000000,725,1262
1187,4.000000000000000,0.000277777777778,38,1174,1136,614.250000000000000,498.950085178868392,2457.000000000000000,4,38,1,25.0000000,38,1,25.0000000,204,1174
1188,4.000000000000000,0.000277777777778,38,1174,1136,614.250000000000000,498.950085178868392,2457.000000000000000,4,38,1,25.0000000,38,1,25.0000000,204,1174
1189,4.000000000000000,0.000277777777778,664,1429,765,1030.250000000000000,327.043861737229349,4121.000000000000000,4,664,1,25.0000000,664,1,25.0000000,755,1429
1190,4.000000000000000,0.000277777777778,636,2459,1823,1747.500000000000000,679.684669534336308,6990.000000000000000,4,636,1,25.0000000,636,1,25.0000000,1833,2459
1191,4.000000000000000,0.000277777777778,636,2459,1823,1747.500000000000000,679.684669534336308,6990.000000000000000,4,636,1,25.0000000,636,1,25.0000000,1833,2459
1192,4.000000000000000,0.000277777777778,648,1491,843,1011.750000000000000,315.801658482028870,4047.000000000000000,4,648,1,25.0000000,648,1,25.0000000,831,1491
1193,3.000000000000000,0.000208333333333,36,1613,1577,562.666666666666629,742.698832337546946,1688.000000000000000,3,36,1,33.3333015,36,1,33.3333015,39,1613
1194,4.000000000000000,0.000277777777778,450,2785,2335,1280.500000000000000,924.544347232732889,5122.000000000000000,4,450,1,25.0000000,450,1,25.0000000,598,2785
1195,4.000000000000000,0.000277777777778,450,1289,839,790.500000000000000,317.288906203793999,3162.000000000000000,4,450,1,25.0000000,450,1,25.0000000,598,1289
1196,5.000000000000000,0.000347222222222,1270,2808,1538,1784.599999999999909,557.626254762094163,8923.000000000000000,5,1270,1,20.0000000,1270,1,20.0000000,1554,2808
1197,4.000000000000000,0.000277777777778,700,1080,380,857.000000000000000,162.663763635297698,3428.000000000000000,4,700,1,25.0000000,700,1,25.0000000,703,1080
1198,5.000000000000000,0.000347222222222,117,2585,2468,1045.799999999999955,982.539240946640348,5229.000000000000000,5,117,1,20.0000000,117,1,20.0000000,441,2585
1199,4.000000000000000,0.000277777777778,555,972,417,745.500000000000000,186.067863963662461,2982.000000000000000,4,555,1,25.0000000,555,1,25.0000000,569,972
1200,4.000000000000000,0.000277777777778,123,745,622,501.000000000000000,261.751790824819409,2004.000000000000000,3,745,2,50.0000000,123,1,25.0000000,391,745
1201,4.000000000000000,0.000277777777778,83,2513,2430,824.250000000000000,995.128980333705272,3297.000000000000000,4,83,1,25.0000000,83,1,25.0000000,115,2513
1202,4.000000000000000,0.000277777777778,790,3975,3185,2172.000000000000000,1313.401880613850835,8688.000000000000000,4,790,1,25.0000000,790,1,25.0000000,1053,3975
1203,4.000000000000000,0.000277777777778,1438,2209,771,1857.250000000000000,310.245366605208119,7429.000000000000000,4,1438,1,25.0000000,1438,1,25.0000000,1687,2209
1204,3.000000000000000,0.000208333333333,764,977,213,893.333333333333371,92.758946858091392,2680.000000000000000,3,764,1,33.3333015,764,1,33.3333015,939,977
1205,4.000000000000000,0.000277777777778,186,719,533,429.250000000000000,193.136447880766440,1717.000000000000000,4,186,1,25.0000000,186,1,25.0000000,356,719
1206,4.000000000000000,0.000277777777778,754,3390,2636,1604.250000000000000,1046.412054355262171,6417.000000000000000,4,754,1,25.0000000,754,1,25.0000000,1013,3390
1207,4.000000000000000,0.000277777777778,733,1587,854,1245.000000000000000,317.889918053404131,4980.000000000000000,4,733,1,25.0000000,733,1,25.0000000,1257,1587
1208,4.000000000000000,0.000277777777778,1,149,148,62.999999999999993,58.821764679410968,252.000000000000000,4,1,1,25.0000000,1,1,25.0000000,17,149
1209,4.000000000000000,0.000277777777778,0,149,149,58.750000000000007,62.491499421921382,235.000000000000000,4,0,1,25.0000000,0,1,25.0000000,1,149
1210,4.000000000000000,0.000277777777778,545,878,333,659.500000000000000,133.952416924817015,2638.000000000000000,4,545,1,25.0000000,545,1,25.0000000,555,878
1211,5.000000000000000,0.000347222222222,41,724,683,314.000000000000000,293.385071194837735,1570.000000000000000,5,41,1,20.0000000,41,1,20.0000000,104,724
1212,3.000000000000000,0.000208333333333,1306,1877,571,1685.333333333333258,268.234143157718734,5056.000000000000000,3,1306,1,33.3333015,1306,1,33.3333015,1873,1877
1213,4.000000000000000,0.000277777777778,537,1412,875,910.000000000000000,316.898248654043527,3640.000000000000000,4,537,1,25.0000000,537,1,25.0000000,812,1412
1214,3.000000000000000,0.000208333333333,1105,2618,1513,1764.666666666666515,632.678082088794554,5294.000000000000000,3,1105,1,33.3333015,1105,1,33.3333015,1571,2618
1215,4.000000000000000,0.000277777777778,685,2618,1933,1622.750000000000000,684.216477074324757,6491.000000000000000,4,685,1,25.0000000,685,1,25.0000000,1571,2618
1216,3.000000000000000,0.000208333333333,3,436,433,168.333333333333314,191.008434950455040,505.000000000000000,3,3,1,33.3333015,3,1,33.3333015,66,436
1217,5.000000000000000,0.000347222222222,3,436,433,113.400000000000006,162.534427122379213,567.000000000000000,5,3,1,20.0000000,3,1,20.0000000,32,436
1218,4.000000000000000,0.000277777777778,3,66,63,32.750000000000000,22.353690970396812,131.000000000000000,4,3,1,25.0000000,3,1,25.0000000,30,66
1219,4.000000000000000,0.000277777777778,3,102,99,50.750000000000000,37.049797570297201,203.000000000000000,4,3,1,25.0000000,3,1,25.0000000,32,102
1220,4.000000000000000,0.000277777777778,3,436,433,125.250000000000000,179.776771302635211,501.000000000000000,4,3,1,25.0000000,3,1,25.0000000,30,436
1221,3.000000000000000,0.000208333333333,447,1285,838,821.000000000000000,347.980842384558116,2463.000000000000000,3,447,1,33.3333015,447,1,33.3333015,731,1285
1222,4.000000000000000,0.000277777777778,36,1285,1249,761.250000000000000,462.310704505097931,3045.000000000000000,4,36,1,25.0000000,36,1,25.0000000,731,1285
1223,4.000000000000000,0.000277777777778,366,1285,919,707.250000000000000,360.048868210969374,2829.000000000000000,4,366,1,25.0000000,366,1,25.0000000,447,1285
1224,4.000000000000000,0.000277777777778,176,855,679,578.000000000000000,276.120444733815418,2312.000000000000000,4,176,1,25.0000000,176,1,25.0000000,469,855
1225,5.000000000000000,0.000347222222222,0,2315,2315,781.799999999999955,801.085114079646360,3909.000000000000000,5,0,1,20.0000000,0,1,20.0000000,621,2315
1226,4.000000000000000,0.000277777777778,1204,1741,537,1495.000000000000000,191.330865257020150,5980.000000000000000,4,1204,1,25.0000000,1204,1,25.0000000,1507,1741
1227,4.000000000000000,0.000277777777778,616,1187,571,930.000000000000000,235.786980132491635,3720.000000000000000,4,616,1,25.0000000,616,1,25.0000000,791,1187
1228,4.000000000000000,0.000277777777778,616,1187,571,930.000000000000000,235.786980132491635,3720.000000000000000,4,616,1,25.0000000,616,1,25.0000000,791,1187
1229,4.000000000000000,0.000277777777778,548,17741,17193,6979.000000000000909,6790.936938302402268,27916.000000000000000,4,548,1,25.0000000,548,1,25.0000000,1821,17741
1230,4.000000000000000,0.000277777777778,330,1846,1516,1043.750000000000000,642.645460187808453,4175.000000000000000,4,330,1,25.0000000,330,1,25.0000000,502,1846
1231,4.000000000000000,0.000277777777778,325,1846,1521,832.250000000000000,596.892107084689087,3329.000000000000000,4,325,1,25.0000000,325,1,25.0000000,502,1846
1232,5.000000000000000,0.000347222222222,325,1846,1521,900.000000000000000,642.690283106878837,4500.000000000000000,5,325,1,20.0000000,325,1,20.0000000,502,1846
1233,4.000000000000000,0.000277777777778,325,1846,1521,832.250000000000000,596.892107084689087,3329.000000000000000,4,325,1,25.0000000,325,1,25.0000000,502,1846
1234,4.000000000000000,0.000277777777778,330,1846,1516,1043.750000000000000,642.645460187808453,4175.000000000000000,4,330,1,25.0000000,330,1,25.0000000,502,1846
1235,4.000000000000000,0.000277777777778,18,561,543,172.250000000000000,226.388355486760872,689.000000000000000,4,18,1,25.0000000,18,1,25.0000000,19,561
1236,5.000000000000000,0.000347222222222,224,2335,2111,914.600000000000136,743.419289499539445,4573.000000000000000,5,224,1,20.0000000,224,1,20.0000000,577,2335
1237,4.000000000000000,0.000277777777778,637,1943,1306,1181.000000000000000,474.937890676244081,4724.000000000000000,4,637,1,25.0000000,637,1,25.0000000,1041,1943
1238,4.000000000000000,0.000277777777778,571,1761,1190,881.000000000000000,508.210586273052741,3524.000000000000000,4,571,1,25.0000000,571,1,25.0000000,587,1761
1239,4.000000000000000,0.000277777777778,6,521,515,159.000000000000000,209.972617262346859,636.000000000000000,4,6,1,25.0000000,6,1,25.0000000,49,521
1240,4.000000000000000,0.000277777777778,92,1736,1644,816.249999999999886,590.134041976905451,3265.000000000000000,4,92,1,25.0000000,92,1,25.0000000,677,1736
1241,4.000000000000000,0.000277777777778,92,760,668,526.250000000000000,259.042829470340678,2105.000000000000000,4,92,1,25.0000000,92,1,25.0000000,576,760
1242,4.000000000000000,0.000277777777778,0,486,486,127.000000000000000,207.394551519561389,508.000000000000000,4,0,1,25.0000000,0,1,25.0000000,3,486
1243,4.000000000000000,0.000277777777778,0,486,486,127.000000000000000,207.394551519561389,508.000000000000000,4,0,1,25.0000000,0,1,25.0000000,3,486
1244,3.000000000000000,0.000208333333333,583,1120,537,804.000000000000000,229.290209123721638,2412.000000000000000,3,583,1,33.3333015,583,1,33.3333015,709,1120
1245,4.000000000000000,0.000277777777778,583,1120,537,820.500000000000000,200.617172744508593,3282.000000000000000,4,583,1,25.0000000,583,1,25.0000000,709,1120
1246,4.000000000000000,0.000277777777778,292,1344,1052,902.250000000000000,446.166098555235408,3609.000000000000000,4,292,1,25.0000000,292,1,25.0000000,659,1344
1247,4.000000000000000,0.000277777777778,4061,7219,3158,5751.500000000000000,1354.517349464376593,23006.000000000000000,4,4061,1,25.0000000,4061,1,25.0000000,4790,7219
1248,4.000000000000000,0.000277777777778,494,1018,524,694.750000000000000,195.163232961539137,2779.000000000000000,4,494,1,25.0000000,494,1,25.0000000,628,1018
1249,4.000000000000000,0.000277777777778,681,1186,505,942.250000000000000,239.776328064302447,3769.000000000000000,4,681,1,25.0000000,681,1,25.0000000,725,1186
1250,4.000000000000000,0.000277777777778,238,1078,840,625.750000000000000,307.564932168802386,2503.000000000000000,4,238,1,25.0000000,238,1,25.0000000,490,1078
1251,5.000000000000000,0.000347222222222,188,1674,1486,793.399999999999977,484.735639292181588,3967.000000000000000,4,666,2,40.0000000,188,1,20.0000000,666,1674
1252,4.000000000000000,0.000277777777778,721,2755,2034,1691.500000000000000,814.879592332511379,6766.000000000000000,4,721,1,25.0000000,721,1,25.0000000,1107,2755
1253,4.000000000000000,0.000277777777778,553,863,310,699.500000000000000,116.844982776326361,2798.000000000000000,4,553,1,25.0000000,553,1,25.0000000,635,863
1254,5.000000000000000,0.000347222222222,233,1094,861,724.600000000000023,311.839445869184431,3623.000000000000000,5,233,1,20.0000000,233,1,20.0000000,692,1094
1255,4.000000000000000,0.000277777777778,464,2785,2321,1635.750000000000000,1125.858200440890414,6543.000000000000000,4,464,1,25.0000000,464,1,25.0000000,557,2785
1256,4.000000000000000,0.000277777777778,201,2981,2780,1008.750000000000000,1142.440452496321541,4035.000000000000000,4,201,1,25.0000000,201,1,25.0000000,412,2981
1257,4.000000000000000,0.000277777777778,463,1789,1326,1064.750000000000000,472.997026946258927,4259.000000000000000,4,463,1,25.0000000,463,1,25.0000000,984,1789
1258,4.000000000000000,0.000277777777778,849,1926,1077,1554.500000000000000,424.860271148056370,6218.000000000000000,4,849,1,25.0000000,849,1,25.0000000,1598,1926
1259,4.000000000000000,0.000277777777778,93,872,779,340.000000000000000,317.824637182204640,1360.000000000000000,4,93,1,25.0000000,93,1,25.0000000,99,872
1260,5.000000000000000,0.000347222222222,480,3060,2580,1541.000000000000000,1148.164448151918577,7705.000000000000000,5,480,1,20.0000000,480,1,20.0000000,723,3060
1261,4.000000000000000,0.000277777777778,547,665,118,596.000000000000000,42.901048938225273,2384.000000000000000,3,586,2,50.0000000,547,1,25.0000000,586,665
1262,4.000000000000000,0.000277777777778,615,1686,1071,1084.250000000000000,420.487440359400011,4337.000000000000000,4,615,1,25.0000000,615,1,25.0000000,777,1686
1263,4.000000000000000,0.000277777777778,96,5035,4939,2360.500000000000000,1917.305726794764496,9442.000000000000000,4,96,1,25.0000000,96,1,25.0000000,1074,5035
1264,4.000000000000000,0.000277777777778,331,958,627,714.500000000000000,242.677254805636892,2858.000000000000000,4,331,1,25.0000000,331,1,25.0000000,686,958
1265,5.000000000000000,0.000347222222222,191,2785,2594,1251.000000000000000,860.233689179864768,6255.000000000000000,5,191,1,20.0000000,191,1,20.0000000,1208,2785
1266,4.000000000000000,0.000277777777778,38,1174,1136,614.250000000000000,498.950085178868392,2457.000000000000000,4,38,1,25.0000000,38,1,25.0000000,204,1174
1267,4.000000000000000,0.000277777777778,38,2939,2901,1069.000000000000000,1142.187156292697864,4276.000000000000000,4,38,1,25.0000000,38,1,25.0000000,258,2939
1268,4.000000000000000,0.000277777777778,831,1805,974,1276.750000000000000,403.089552705102960,5107.000000000000000,4,831,1,25.0000000,831,1,25.0000000,945,1805
1269,4.000000000000000,0.000277777777778,831,1805,974,1276.750000000000000,403.089552705102960,5107.000000000000000,4,831,1,25.0000000,831,1,25.0000000,945,1805
1270,4.000000000000000,0.000277777777778,831,1805,974,1276.750000000000000,403.089552705102960,5107.000000000000000,4,831,1,25.0000000,831,1,25.0000000,945,1805
1271,4.000000000000000,0.000277777777778,415,627,212,544.500000000000000,86.433500449767735,2178.000000000000000,4,415,1,25.0000000,415,1,25.0000000,517,627
1272,5.000000000000000,0.000347222222222,41,724,683,314.000000000000000,293.385071194837735,1570.000000000000000,5,41,1,20.0000000,41,1,20.0000000,104,724
1273,3.000000000000000,0.000208333333333,379,3159,2780,1382.666666666666515,1259.592614917837409,4148.000000000000000,3,379,1,33.3333015,379,1,33.3333015,610,3159
1274,3.000000000000000,0.000208333333333,586,715,129,654.000000000000000,52.896124621752776,1962.000000000000000,3,586,1,33.3333015,586,1,33.3333015,661,715
1275,4.000000000000000,0.000277777777778,439,1186,747,637.000000000000000,317.108025757784958,2548.000000000000000,4,439,1,25.0000000,439,1,25.0000000,458,1186
1276,4.000000000000000,0.000277777777778,36,869,833,447.000000000000000,330.352084903364869,1788.000000000000000,4,36,1,25.0000000,36,1,25.0000000,230,869
1277,4.000000000000000,0.000277777777778,512,2325,1813,1017.250000000000000,759.789896945201576,4069.000000000000000,3,512,2,50.0000000,720,1,25.0000000,512,2325
1278,4.000000000000000,0.000277777777778,171,863,692,636.500000000000000,276.018568215980736,2546.000000000000000,4,171,1,25.0000000,171,1,25.0000000,692,863
1279,3.000000000000000,0.000208333333333,705,1454,749,1053.000000000000000,308.066010242393759,3159.000000000000000,3,705,1,33.3333015,705,1,33.3333015,1000,1454
1280,3.000000000000000,0.000208333333333,731,1822,1091,1215.333333333333258,453.721157638575335,3646.000000000000000,3,731,1,33.3333015,731,1,33.3333015,1093,1822
1281,4.000000000000000,0.000277777777778,170,914,744,539.750000000000000,350.931884416335151,2159.000000000000000,4,170,1,25.0000000,170,1,25.0000000,209,914
1282,4.000000000000000,0.000277777777778,4557,7219,2662,5875.500000000000000,1208.967017746969077,23502.000000000000000,4,4557,1,25.0000000,4557,1,25.0000000,4790,7219
1283,4.000000000000000,0.000277777777778,294,7238,6944,2275.000000000000000,2879.876907091690100,9100.000000000000000,4,294,1,25.0000000,294,1,25.0000000,490,7238
1284,4.000000000000000,0.000277777777778,294,7238,6944,2275.000000000000000,2879.876907091690100,9100.000000000000000,4,294,1,25.0000000,294,1,25.0000000,490,7238
1285,2.000000000000000,0.000138888888889,294,1078,784,686.000000000000000,392.000000000000000,1372.000000000000000,2,294,1,50.0000000,294,1,50.0000000,294,1078
1286,4.000000000000000,0.000277777777778,406,1294,888,818.750000000000000,367.499234693080666,3275.000000000000000,4,406,1,25.0000000,406,1,25.0000000,521,1294
1287,4.000000000000000,0.000277777777778,259,1827,1568,801.500000000000000,610.516789285929462,3206.000000000000000,4,259,1,25.0000000,259,1,25.0000000,441,1827
1288,4.000000000000000,0.000277777777778,4,161,157,84.750000000000000,60.532532575467222,339.000000000000000,4,4,1,25.0000000,4,1,25.0000000,53,161
1289,4.000000000000000,0.000277777777778,4,161,157,84.750000000000000,60.532532575467222,339.000000000000000,4,4,1,25.0000000,4,1,25.0000000,53,161
1290,4.000000000000000,0.000277777777778,330,1846,1516,1043.750000000000000,642.645460187808453,4175.000000000000000,4,330,1,25.0000000,330,1,25.0000000,502,1846
1291,4.000000000000000,0.000277777777778,330,1598,1268,1019.000000000000000,541.726406962038368,4076.000000000000000,4,330,1,25.0000000,330,1,25.0000000,651,1598
1292,3.000000000000000,0.000208333333333,330,1497,1167,826.000000000000000,492.233684341086132,2478.000000000000000,3,330,1,33.3333015,330,1,33.3333015,651,1497
1293,4.000000000000000,0.000277777777778,330,1598,1268,1019.000000000000000,541.726406962038368,4076.000000000000000,4,330,1,25.0000000,330,1,25.0000000,651,1598
1294,4.000000000000000,0.000277777777778,330,1497,1167,745.000000000000000,448.780012923926961,2980.000000000000000,4,330,1,25.0000000,330,1,25.0000000,502,1497
1295,4.000000000000000,0.000277777777778,330,1598,1268,1019.000000000000000,541.726406962038368,4076.000000000000000,4,330,1,25.0000000,330,1,25.0000000,651,1598
1296,4.000000000000000,0.000277777777778,330,1497,1167,745.000000000000000,448.780012923926961,2980.000000000000000,4,330,1,25.0000000,330,1,25.0000000,502,1497
1297,4.000000000000000,0.000277777777778,330,1598,1268,1019.000000000000000,541.726406962038368,4076.000000000000000,4,330,1,25.0000000,330,1,25.0000000,651,1598
1298,3.000000000000000,0.000208333333333,12,651,639,331.000000000000000,260.871615933968542,993.000000000000000,3,12,1,33.3333015,12,1,33.3333015,330,651
1299,4.000000000000000,0.000277777777778,330,1598,1268,1019.000000000000000,541.726406962038368,4076.000000000000000,4,330,1,25.0000000,330,1,25.0000000,651,1598
1300,4.000000000000000,0.000277777777778,97,2143,2046,898.500000000000000,756.562786555088337,3594.000000000000000,4,97,1,25.0000000,97,1,25.0000000,666,2143
1301,4.000000000000000,0.000277777777778,218,1074,856,632.750000000000000,415.173081376912023,2531.000000000000000,3,218,2,50.0000000,1021,1,25.0000000,218,1074
1302,4.000000000000000,0.000277777777778,690,1138,448,911.250000000000000,199.074577734074325,3645.000000000000000,4,690,1,25.0000000,690,1,25.0000000,738,1138
1303,4.000000000000000,0.000277777777778,477,7238,6761,2320.000000000000000,2842.835292450127326,9280.000000000000000,4,477,1,25.0000000,477,1,25.0000000,694,7238
1304,4.000000000000000,0.000277777777778,97,510,413,276.500000000000000,167.467160959992384,1106.000000000000000,4,97,1,25.0000000,97,1,25.0000000,140,510
1305,4.000000000000000,0.000277777777778,195,932,737,404.000000000000000,305.682024332475237,1616.000000000000000,4,195,1,25.0000000,195,1,25.0000000,230,932
1306,3.000000000000000,0.000208333333333,0,4,4,2.000000000000000,1.632993161855452,6.000000000000000,3,0,1,33.3333015,0,1,33.3333015,2,4
1307,4.000000000000000,0.000277777777778,482,1002,520,633.250000000000000,213.922152896795609,2533.000000000000000,4,482,1,25.0000000,482,1,25.0000000,508,1002
1308,5.000000000000000,0.000347222222222,5449,14919,9470,11316.600000000000364,3437.623399966901616,56583.000000000000000,5,5449,1,20.0000000,5449,1,20.0000000,12367,14919
1309,4.000000000000000,0.000277777777778,396,1348,952,679.000000000000000,391.046672406248717,2716.000000000000000,4,396,1,25.0000000,396,1,25.0000000,417,1348
1310,4.000000000000000,0.000277777777778,211,2618,2407,974.500000000000114,958.045536496047816,3898.000000000000000,4,211,1,25.0000000,211,1,25.0000000,525,2618
1311,3.000000000000000,0.000208333333333,241,336,95,291.333333333333314,38.990027214945904,874.000000000000000,3,241,1,33.3333015,241,1,33.3333015,297,336
1312,4.000000000000000,0.000277777777778,3,49,46,28.500000000000000,16.469669092000604,114.000000000000000,4,3,1,25.0000000,3,1,25.0000000,30,49
1313,4.000000000000000,0.000277777777778,3,66,63,32.750000000000000,22.353690970396812,131.000000000000000,4,3,1,25.0000000,3,1,25.0000000,30,66
1314,4.000000000000000,0.000277777777778,3,102,99,50.750000000000000,37.049797570297201,203.000000000000000,4,3,1,25.0000000,3,1,25.0000000,32,102
1315,4.000000000000000,0.000277777777778,580,2585,2005,1376.250000000000000,771.548240552721381,5505.000000000000000,4,580,1,25.0000000,580,1,25.0000000,853,2585
1316,4.000000000000000,0.000277777777778,402,1097,695,645.750000000000000,269.545334776916491,2583.000000000000000,4,402,1,25.0000000,402,1,25.0000000,487,1097
1317,4.000000000000000,0.000277777777778,696,972,276,801.500000000000000,103.260592676974312,3206.000000000000000,4,696,1,25.0000000,696,1,25.0000000,756,972
1318,4.000000000000000,0.000277777777778,235,5087,4852,2478.500000000000000,2065.736854006337580,9914.000000000000000,4,235,1,25.0000000,235,1,25.0000000,689,5087
1319,4.000000000000000,0.000277777777778,893,1018,125,979.250000000000000,51.138903977304793,3917.000000000000000,4,893,1,25.0000000,893,1,25.0000000,989,1018
1320,4.000000000000000,0.000277777777778,747,2236,1489,1285.750000000000000,582.132018961334893,5143.000000000000000,4,747,1,25.0000000,747,1,25.0000000,883,2236
1321,3.000000000000000,0.000208333333333,359,734,375,600.333333333333371,170.978231232971751,1801.000000000000000,3,359,1,33.3333015,359,1,33.3333015,708,734
1322,4.000000000000000,0.000277777777778,1159,2502,1343,1720.750000000000000,519.139371941678064,6883.000000000000000,4,1159,1,25.0000000,1159,1,25.0000000,1358,2502
1323,4.000000000000000,0.000277777777778,136,2478,2342,919.750000000000000,927.784019855914494,3679.000000000000000,4,136,1,25.0000000,136,1,25.0000000,308,2478
1324,4.000000000000000,0.000277777777778,1370,2459,1089,1744.000000000000000,444.990449335713265,6976.000000000000000,3,1370,2,50.0000000,1777,1,25.0000000,1370,2459
1325,4.000000000000000,0.000277777777778,180,2498,2318,1219.500000000000000,850.242759451675624,4878.000000000000000,4,180,1,25.0000000,180,1,25.0000000,828,2498
1326,4.000000000000000,0.000277777777778,41,320,279,164.000000000000000,105.501184827470070,656.000000000000000,4,41,1,25.0000000,41,1,25.0000000,100,320
1327,4.000000000000000,0.000277777777778,140,653,513,431.000000000000000,186.138389377366224,1724.000000000000000,4,140,1,25.0000000,140,1,25.0000000,432,653
1328,5.000000000000000,0.000347222222222,140,653,513,446.800000000000011,169.459611707332783,2234.000000000000000,5,140,1,20.0000000,140,1,20.0000000,499,653
1329,4.000000000000000,0.000277777777778,132,3636,3504,1094.000000000000000,1469.477458146262279,4376.000000000000000,4,132,1,25.0000000,132,1,25.0000000,272,3636
1330,4.000000000000000,0.000277777777778,331,842,511,618.250000000000000,208.779039896250111,2473.000000000000000,4,331,1,25.0000000,331,1,25.0000000,509,842
1331,4.000000000000000,0.000277777777778,207,2479,2272,987.000000000000000,887.696175501505650,3948.000000000000000,4,207,1,25.0000000,207,1,25.0000000,452,2479
1332,4.000000000000000,0.000277777777778,149,2479,2330,885.249999999999886,928.681424117011147,3541.000000000000000,4,149,1,25.0000000,149,1,25.0000000,452,2479
1333,4.000000000000000,0.000277777777778,149,2479,2330,885.249999999999886,928.681424117011147,3541.000000000000000,4,149,1,25.0000000,149,1,25.0000000,452,2479
1334,4.000000000000000,0.000277777777778,0,16,16,5.000000000000000,6.557438524302000,20.000000000000000,3,0,2,50.0000000,4,1,25.0000000,0,16
1335,4.000000000000000,0.000277777777778,1805,5460,3655,3692.750000000000000,1465.885632476149112,14771.000000000000000,4,1805,1,25.0000000,1805,1,25.0000000,2778,5460
1336,4.000000000000000,0.000277777777778,340,1485,1145,1023.250000000000000,485.089360324466384,4093.000000000000000,4,340,1,25.0000000,340,1,25.0000000,790,1485
1337,4.000000000000000,0.000277777777778,974,1096,122,1018.500000000000000,50.246890451051776,4074.000000000000000,3,974,2,50.0000000,1030,1,25.0000000,974,1096
1338,4.000000000000000,0.000277777777778,73,494,421,275.250000000000000,189.303162942408335,1101.000000000000000,4,73,1,25.0000000,73,1,25.0000000,102,494
1339,4.000000000000000,0.000277777777778,0,1460,1460,977.750000000000000,573.859902328085695,3911.000000000000000,4,0,1,25.0000000,0,1,25.0000000,1171,1460
1340,4.000000000000000,0.000277777777778,560,1120,560,841.750000000000000,219.654700609843530,3367.000000000000000,4,560,1,25.0000000,560,1,25.0000000,709,1120
1341,4.000000000000000,0.000277777777778,616,990,374,771.750000000000000,137.572480896435110,3087.000000000000000,4,616,1,25.0000000,616,1,25.0000000,710,990
1342,4.000000000000000,0.000277777777778,112,826,714,445.000000000000057,307.104216838518880,1780.000000000000000,4,112,1,25.0000000,112,1,25.0000000,176,826
1343,4.000000000000000,0.000277777777778,4,161,157,84.750000000000000,60.532532575467222,339.000000000000000,4,4,1,25.0000000,4,1,25.0000000,53,161
1344,4.000000000000000,0.000277777777778,4,161,157,84.750000000000000,60.532532575467222,339.000000000000000,4,4,1,25.0000000,4,1,25.0000000,53,161
1345,4.000000000000000,0.000277777777778,27,84,57,56.250000000000000,23.847169643376969,225.000000000000000,4,27,1,25.0000000,27,1,25.0000000,39,84
1346,4.000000000000000,0.000277777777778,182,405,223,268.000000000000000,83.585285786434923,1072.000000000000000,4,182,1,25.0000000,182,1,25.0000000,227,405
1347,4.000000000000000,0.000277777777778,37,436,399,276.250000000000000,159.501371467457915,1105.000000000000000,4,37,1,25.0000000,37,1,25.0000000,227,436
1348,3.000000000000000,0.000208333333333,436,1394,958,996.333333333333371,407.665167617848965,2989.000000000000000,3,436,1,33.3333015,436,1,33.3333015,1159,1394
1349,5.000000000000000,0.000347222222222,262,1162,900,832.000000000000000,346.125988622640136,4160.000000000000000,4,1068,2,40.0000000,262,1,20.0000000,1068,1162
1350,4.000000000000000,0.000277777777778,73,476,403,211.000000000000000,164.646591218889199,844.000000000000000,3,73,2,50.0000000,222,1,25.0000000,73,476
1351,5.000000000000000,0.000347222222222,645,1094,449,795.200000000000045,158.218077348955291,3976.000000000000000,5,645,1,20.0000000,645,1,20.0000000,755,1094
1352,4.000000000000000,0.000277777777778,764,1009,245,922.250000000000000,94.666189846216994,3689.000000000000000,4,764,1,25.0000000,764,1,25.0000000,939,1009
1353,4.000000000000000,0.000277777777778,102,814,712,326.750000000000000,285.477998276574738,1307.000000000000000,4,102,1,25.0000000,102,1,25.0000000,153,814
1354,3.000000000000000,0.000208333333333,102,238,136,173.666666666666657,55.763389025018512,521.000000000000000,3,102,1,33.3333015,102,1,33.3333015,181,238
1355,4.000000000000000,0.000277777777778,102,814,712,326.750000000000000,285.477998276574738,1307.000000000000000,4,102,1,25.0000000,102,1,25.0000000,153,814
1356,4.000000000000000,0.000277777777778,31,609,578,307.000000000000000,261.055549644132270,1228.000000000000000,4,31,1,25.0000000,31,1,25.0000000,65,609
1357,4.000000000000000,0.000277777777778,446,2087,1641,1303.750000000000000,584.621405270111495,5215.000000000000000,4,446,1,25.0000000,446,1,25.0000000,1254,2087
1358,4.000000000000000,0.000277777777778,186,2254,2068,926.250000000000000,787.951894153443845,3705.000000000000000,4,186,1,25.0000000,186,1,25.0000000,631,2254
1359,4.000000000000000,0.000277777777778,633,988,355,740.750000000000000,145.474009706201485,2963.000000000000000,4,633,1,25.0000000,633,1,25.0000000,638,988
1360,4.000000000000000,0.000277777777778,842,1380,538,1036.750000000000000,206.600308567049325,4147.000000000000000,4,842,1,25.0000000,842,1,25.0000000,918,1380
1361,4.000000000000000,0.000277777777778,73,782,709,300.000000000000000,281.445376583094742,1200.000000000000000,4,73,1,25.0000000,73,1,25.0000000,157,782
1362,4.000000000000000,0.000277777777778,195,265,70,245.250000000000000,29.243589041018890,981.000000000000000,3,265,2,50.0000000,195,1,25.0000000,256,265
1363,4.000000000000000,0.000277777777778,31,503,472,365.000000000000000,194.396502026142429,1460.000000000000000,4,31,1,25.0000000,31,1,25.0000000,437,503
1364,4.000000000000000,0.000277777777778,31,503,472,365.000000000000000,194.396502026142429,1460.000000000000000,4,31,1,25.0000000,31,1,25.0000000,437,503
1365,4.000000000000000,0.000277777777778,689,5087,4398,1793.500000000000000,1901.508677340179929,7174.000000000000000,4,689,1,25.0000000,689,1,25.0000000,696,5087
1366,5.000000000000000,0.000347222222222,689,5087,4398,2308.400000000000091,1832.095587025961095,11542.000000000000000,5,689,1,20.0000000,689,1,20.0000000,1161,5087
1367,4.000000000000000,0.000277777777778,240,947,707,730.250000000000000,284.980152817700628,2921.000000000000000,4,240,1,25.0000000,240,1,25.0000000,859,947
1368,4.000000000000000,0.000277777777778,235,3903,3668,1581.250000000000000,1394.508582798972839,6325.000000000000000,4,235,1,25.0000000,235,1,25.0000000,870,3903
1369,4.000000000000000,0.000277777777778,235,3903,3668,1581.250000000000000,1394.508582798972839,6325.000000000000000,4,235,1,25.0000000,235,1,25.0000000,870,3903
1370,5.000000000000000,0.000347222222222,28,451,423,230.599999999999994,157.858924359695294,1153.000000000000000,5,28,1,20.0000000,28,1,20.0000000,154,451
1371,4.000000000000000,0.000277777777778,1438,2209,771,1768.500000000000000,317.437001623944298,7074.000000000000000,4,1438,1,25.0000000,1438,1,25.0000000,1497,2209
1372,4.000000000000000,0.000277777777778,784,1685,901,1259.000000000000000,352.165444074230550,5036.000000000000000,4,784,1,25.0000000,784,1,25.0000000,1074,1685
1373,4.000000000000000,0.000277777777778,1016,1398,382,1194.500000000000000,135.634619474527966,4778.000000000000000,3,1182,2,50.0000000,1016,1,25.0000000,1182,1398
1374,3.000000000000000,0.000208333333333,140,2725,2585,1009.333333333333371,1213.195871334147796,3028.000000000000000,3,140,1,33.3333015,140,1,33.3333015,163,2725
1375,4.000000000000000,0.000277777777778,1587,16709,15122,9084.500000000000000,7253.599434074092642,36338.000000000000000,4,1587,1,25.0000000,1587,1,25.0000000,2089,16709
1376,4.000000000000000,0.000277777777778,142,1094,952,687.250000000000000,393.279401316672079,2749.000000000000000,4,142,1,25.0000000,142,1,25.0000000,486,1094
1377,4.000000000000000,0.000277777777778,285,758,473,561.250000000000000,175.208982361065040,2245.000000000000000,4,285,1,25.0000000,285,1,25.0000000,553,758
1378,3.000000000000000,0.000208333333333,910,1034,124,971.666666666666629,50.624982853220679,2915.000000000000000,3,910,1,33.3333015,910,1,33.3333015,971,1034
1379,4.000000000000000,0.000277777777778,384,1246,862,799.250000000000000,305.366480642522390,3197.000000000000000,4,384,1,25.0000000,384,1,25.0000000,768,1246
1380,6.000000000000000,0.000416666666667,1805,5460,3655,3964.500000000000000,1275.585453821107194,23787.000000000000000,6,1805,1,16.6667004,1805,1,16.6667004,4133,4883
1381,4.000000000000000,0.000277777777778,1166,2319,1153,1688.250000000000000,494.752147544606430,6753.000000000000000,4,1166,1,25.0000000,1166,1,25.0000000,1245,2319
1382,4.000000000000000,0.000277777777778,646,1475,829,994.000000000000000,351.032049818816404,3976.000000000000000,4,646,1,25.0000000,646,1,25.0000000,671,1475
1383,4.000000000000000,0.000277777777778,1376,1995,619,1642.500000000000000,272.534860155540457,6570.000000000000000,4,1376,1,25.0000000,1376,1,25.0000000,1378,1995
1384,4.000000000000000,0.000277777777778,361,1208,847,819.750000000000000,325.663457421921976,3279.000000000000000,4,361,1,25.0000000,361,1,25.0000000,681,1208
1385,4.000000000000000,0.000277777777778,681,1316,635,1058.500000000000000,240.849019097026854,4234.000000000000000,4,681,1,25.0000000,681,1,25.0000000,1029,1316
1386,4.000000000000000,0.000277777777778,368,2185,1817,1279.500000000000000,643.485236815888356,5118.000000000000000,4,368,1,25.0000000,368,1,25.0000000,1230,2185
1387,6.000000000000000,0.000416666666667,368,2185,1817,1200.000000000000000,614.642714645400019,7200.000000000000000,6,368,1,16.6667004,368,1,16.6667004,1230,1558
1388,4.000000000000000,0.000277777777778,12,651,639,318.750000000000000,306.324480738970692,1275.000000000000000,4,12,1,25.0000000,12,1,25.0000000,14,651
1389,4.000000000000000,0.000277777777778,3,2588,2585,953.000000000000000,1053.939039982863505,3812.000000000000000,4,3,1,25.0000000,3,1,25.0000000,48,2588
1390,4.000000000000000,0.000277777777778,651,1590,939,1127.000000000000000,371.150239121571872,4508.000000000000000,4,651,1,25.0000000,651,1,25.0000000,899,1590
1391,4.000000000000000,0.000277777777778,1452,2005,553,1752.250000000000000,235.270456071305318,7009.000000000000000,4,1452,1,25.0000000,1452,1,25.0000000,1594,2005
1392,4.000000000000000,0.000277777777778,108,1055,947,454.000000000000000,359.006267354763622,1816.000000000000000,4,108,1,25.0000000,108,1,25.0000000,294,1055
1393,4.000000000000000,0.000277777777778,776,1831,1055,1128.000000000000000,416.841096822278303,4512.000000000000000,4,776,1,25.0000000,776,1,25.0000000,865,1831
1394,6.000000000000000,0.000416666666667,872,1434,562,1182.166666666666742,205.081623316722869,7093.000000000000000,6,872,1,16.6667004,872,1,16.6667004,1093,1363
1395,4.000000000000000,0.000277777777778,872,1363,491,1163.500000000000000,197.578465425764449,4654.000000000000000,4,872,1,25.0000000,872,1,25.0000000,1093,1363
1396,4.000000000000000,0.000277777777778,872,1326,454,1074.000000000000000,165.401027808172927,4296.000000000000000,4,872,1,25.0000000,872,1,25.0000000,1005,1326
1397,4.000000000000000,0.000277777777778,3,49,46,28.500000000000000,16.469669092000604,114.000000000000000,4,3,1,25.0000000,3,1,25.0000000,30,49
1398,4.000000000000000,0.000277777777778,0,60,60,34.750000000000000,22.752747086890409,139.000000000000000,4,0,1,25.0000000,0,1,25.0000000,30,60
1399,4.000000000000000,0.000277777777778,3,49,46,28.500000000000000,16.469669092000604,114.000000000000000,4,3,1,25.0000000,3,1,25.0000000,30,49
1400,4.000000000000000,0.000277777777778,1143,2538,1395,1815.250000000000000,540.890642829028820,7261.000000000000000,4,1143,1,25.0000000,1143,1,25.0000000,1478,2538
1401,4.000000000000000,0.000277777777778,431,497,66,459.250000000000000,25.926579026165406,1837.000000000000000,4,431,1,25.0000000,431,1,25.0000000,440,497
1402,4.000000000000000,0.000277777777778,14,1623,1609,655.000000000000000,600.893917426362350,2620.000000000000000,4,14,1,25.0000000,14,1,25.0000000,345,1623
1403,4.000000000000000,0.000277777777778,590,938,348,765.500000000000000,129.925940443007761,3062.000000000000000,4,590,1,25.0000000,590,1,25.0000000,708,938
1404,4.000000000000000,0.000277777777778,550,875,325,724.500000000000000,137.906671339714393,2898.000000000000000,4,550,1,25.0000000,550,1,25.0000000,630,875
1405,4.000000000000000,0.000277777777778,0,60,60,34.750000000000000,22.752747086890409,139.000000000000000,4,0,1,25.0000000,0,1,25.0000000,30,60
1406,5.000000000000000,0.000347222222222,14,2305,2291,974.000000000000000,765.651356689191857,4870.000000000000000,5,14,1,20.0000000,14,1,20.0000000,681,2305
1407,4.000000000000000,0.000277777777778,53,1929,1876,749.750000000000000,737.275177596533467,2999.000000000000000,4,53,1,25.0000000,53,1,25.0000000,207,1929
1408,4.000000000000000,0.000277777777778,3,292,289,82.000000000000000,121.690180376232490,328.000000000000000,4,3,1,25.0000000,3,1,25.0000000,4,292
1409,5.000000000000000,0.000347222222222,441,1518,1077,800.200000000000045,435.838226868639879,4001.000000000000000,5,441,1,20.0000000,441,1,20.0000000,480,1518
1410,4.000000000000000,0.000277777777778,513,1965,1452,1089.250000000000000,611.517119547768630,4357.000000000000000,4,513,1,25.0000000,513,1,25.0000000,520,1965
1411,4.000000000000000,0.000277777777778,37,574,537,190.750000000000000,222.094996566784459,763.000000000000000,4,37,1,25.0000000,37,1,25.0000000,61,574
1412,4.000000000000000,0.000277777777778,358,2693,2335,1492.250000000000000,835.431737187425711,5969.000000000000000,4,358,1,25.0000000,358,1,25.0000000,1284,2693
1413,4.000000000000000,0.000277777777778,513,3032,2519,1507.500000000000000,1060.376466166615728,6030.000000000000000,4,513,1,25.0000000,513,1,25.0000000,520,3032
1414,4.000000000000000,0.000277777777778,1124,3646,2522,2094.000000000000000,1046.379233356625718,8376.000000000000000,4,1124,1,25.0000000,1124,1,25.0000000,1147,3646
1415,4.000000000000000,0.000277777777778,1326,4244,2918,2636.750000000000000,1048.580796839232562,10547.000000000000000,4,1326,1,25.0000000,1326,1,25.0000000,2326,4244
1416,4.000000000000000,0.000277777777778,1257,2136,879,1802.250000000000000,333.987555905904969,7209.000000000000000,4,1257,1,25.0000000,1257,1,25.0000000,1821,2136
1417,4.000000000000000,0.000277777777778,464,969,505,650.500000000000000,195.256882081016556,2602.000000000000000,4,464,1,25.0000000,464,1,25.0000000,523,969
1418,4.000000000000000,0.000277777777778,464,969,505,716.000000000000000,224.513919390313077,2864.000000000000000,4,464,1,25.0000000,464,1,25.0000000,523,969
1419,3.000000000000000,0.000208333333333,145,1038,893,453.000000000000000,413.851019893229989,1359.000000000000000,3,145,1,33.3333015,145,1,33.3333015,176,1038
1420,4.000000000000000,0.000277777777778,39,2079,2040,1168.250000000000000,749.520972021463876,4673.000000000000000,4,39,1,25.0000000,39,1,25.0000000,1034,2079
1421,4.000000000000000,0.000277777777778,236,1108,872,663.000000000000000,313.832758009739962,2652.000000000000000,4,236,1,25.0000000,236,1,25.0000000,572,1108
1422,5.000000000000000,0.000347222222222,642,1294,652,902.000000000000000,253.177408154835177,4510.000000000000000,5,642,1,20.0000000,642,1,20.0000000,839,1294
1423,4.000000000000000,0.000277777777778,6,178,172,64.000000000000000,68.894847412560537,256.000000000000000,4,6,1,25.0000000,6,1,25.0000000,13,178
1424,4.000000000000000,0.000277777777778,11,178,167,73.250000000000000,62.945909319033589,293.000000000000000,4,11,1,25.0000000,11,1,25.0000000,45,178
1425,4.000000000000000,0.000277777777778,196,526,330,325.250000000000000,131.816871074987972,1301.000000000000000,4,196,1,25.0000000,196,1,25.0000000,219,526
1426,5.000000000000000,0.000347222222222,0,7510,7510,1857.800000000000182,2854.091827534636195,9289.000000000000000,5,0,1,20.0000000,0,1,20.0000000,628,7510
1427,4.000000000000000,0.000277777777778,804,2326,1522,1566.000000000000000,621.934080108173475,6264.000000000000000,4,804,1,25.0000000,804,1,25.0000000,1126,2326
1428,4.000000000000000,0.000277777777778,445,1591,1146,1116.500000000000000,471.409853524510027,4466.000000000000000,4,445,1,25.0000000,445,1,25.0000000,904,1591
1429,4.000000000000000,0.000277777777778,893,3694,2801,1872.500000000000000,1117.538478084759390,7490.000000000000000,4,893,1,25.0000000,893,1,25.0000000,1025,3694
1430,4.000000000000000,0.000277777777778,969,1251,282,1098.750000000000000,116.778369144289741,4395.000000000000000,4,969,1,25.0000000,969,1,25.0000000,1003,1251
1431,5.000000000000000,0.000347222222222,641,1492,851,982.399999999999977,278.642136081390277,4912.000000000000000,5,641,1,20.0000000,641,1,20.0000000,919,1492
1432,4.000000000000000,0.000277777777778,1358,1795,437,1517.000000000000000,166.962570655820940,6068.000000000000000,4,1358,1,25.0000000,1358,1,25.0000000,1427,1795
1433,4.000000000000000,0.000277777777778,856,1328,472,1127.750000000000000,183.022368851460328,4511.000000000000000,4,856,1,25.0000000,856,1,25.0000000,1070,1328
1434,4.000000000000000,0.000277777777778,450,1289,839,836.500000000000000,298.848205616162261,3346.000000000000000,4,450,1,25.0000000,450,1,25.0000000,782,1289
1435,3.000000000000000,0.000208333333333,47,825,778,440.666666666666686,317.685728704048358,1322.000000000000000,3,47,1,33.3333015,47,1,33.3333015,450,825
1436,3.000000000000000,0.000208333333333,148,857,709,398.333333333333371,324.779241263285712,1195.000000000000000,3,148,1,33.3333015,148,1,33.3333015,190,857
1437,4.000000000000000,0.000277777777778,0,7510,7510,2187.500000000000000,3101.212464504810669,8750.000000000000000,4,0,1,25.0000000,0,1,25.0000000,150,7510
1438,4.000000000000000,0.000277777777778,150,7510,7360,2405.250000000000000,2981.110143470046296,9621.000000000000000,4,150,1,25.0000000,150,1,25.0000000,566,7510
1439,4.000000000000000,0.000277777777778,512,787,275,641.750000000000000,109.376357134437427,2567.000000000000000,4,512,1,25.0000000,512,1,25.0000000,564,787
1440,4.000000000000000,0.000277777777778,692,946,254,770.250000000000000,102.196807680083637,3081.000000000000000,4,692,1,25.0000000,692,1,25.0000000,719,946
1441,5.000000000000000,0.000347222222222,154,2848,2694,965.600000000000023,968.542533913715147,4828.000000000000000,5,154,1,20.0000000,154,1,20.0000000,534,2848
1442,4.000000000000000,0.000277777777778,501,1548,1047,1200.750000000000000,421.277447177035583,4803.000000000000000,4,501,1,25.0000000,501,1,25.0000000,1240,1548
1443,5.000000000000000,0.000347222222222,106,1532,1426,912.799999999999955,471.488451608308196,4564.000000000000000,5,106,1,20.0000000,106,1,20.0000000,989,1532
1444,4.000000000000000,0.000277777777778,640,2120,1480,1468.500000000000000,594.200513294965049,5874.000000000000000,4,640,1,25.0000000,640,1,25.0000000,1179,2120
1445,4.000000000000000,0.000277777777778,639,1015,376,824.000000000000000,168.776479403973809,3296.000000000000000,4,639,1,25.0000000,639,1,25.0000000,674,1015
1446,4.000000000000000,0.000277777777778,639,1015,376,824.000000000000000,168.776479403973809,3296.000000000000000,4,639,1,25.0000000,639,1,25.0000000,674,1015
1447,4.000000000000000,0.000277777777778,621,1292,671,953.750000000000000,283.316408808243978,3815.000000000000000,4,621,1,25.0000000,621,1,25.0000000,732,1292
1448,5.000000000000000,0.000347222222222,209,822,613,549.399999999999977,219.727649602866336,2747.000000000000000,4,663,2,40.0000000,209,1,20.0000000,663,822
1449,5.000000000000000,0.000347222222222,215,1689,1474,913.600000000000023,496.572089429118080,4568.000000000000000,5,215,1,20.0000000,215,1,20.0000000,1001,1689
1450,4.000000000000000,0.000277777777778,662,1257,595,870.500000000000000,241.640745736309952,3482.000000000000000,4,662,1,25.0000000,662,1,25.0000000,670,1257
1451,4.000000000000000,0.000277777777778,623,2538,1915,1611.000000000000000,687.531453825932203,6444.000000000000000,4,623,1,25.0000000,623,1,25.0000000,1478,2538
1452,5.000000000000000,0.000347222222222,587,2397,1810,1449.799999999999955,667.570640456873321,7249.000000000000000,5,587,1,20.0000000,587,1,20.0000000,1215,2397
1453,4.000000000000000,0.000277777777778,46,170,124,109.250000000000000,48.266836440769559,437.000000000000000,4,46,1,25.0000000,46,1,25.0000000,82,170
1454,3.000000000000000,0.000208333333333,46,314,268,166.333333333333343,111.104555362155253,499.000000000000000,3,46,1,33.3333015,46,1,33.3333015,139,314
1455,4.000000000000000,0.000277777777778,791,998,207,902.250000000000000,93.691982047558355,3609.000000000000000,4,791,1,25.0000000,791,1,25.0000000,828,998
1456,4.000000000000000,0.000277777777778,237,784,547,510.500000000000000,196.288690453627510,2042.000000000000000,4,237,1,25.0000000,237,1,25.0000000,463,784
1457,4.000000000000000,0.000277777777778,441,1134,693,874.750000000000000,272.711729670727607,3499.000000000000000,4,441,1,25.0000000,441,1,25.0000000,846,1134
1458,4.000000000000000,0.000277777777778,81,1104,1023,683.000000000000000,437.785906579917196,2732.000000000000000,4,81,1,25.0000000,81,1,25.0000000,449,1104
1459,4.000000000000000,0.000277777777778,1230,6130,4900,3117.000000000000000,1821.766038765680833,12468.000000000000000,4,1230,1,25.0000000,1230,1,25.0000000,2519,6130
1460,4.000000000000000,0.000277777777778,68,654,586,259.500000000000000,235.666607732194421,1038.000000000000000,4,68,1,25.0000000,68,1,25.0000000,90,654
1461,4.000000000000000,0.000277777777778,441,3379,2938,1523.750000000000000,1145.253547254930027,6095.000000000000000,4,441,1,25.0000000,441,1,25.0000000,729,3379
1462,4.000000000000000,0.000277777777778,142,2430,2288,944.750000000000000,879.946411720622791,3779.000000000000000,4,142,1,25.0000000,142,1,25.0000000,520,2430
1463,4.000000000000000,0.000277777777778,257,1108,851,627.250000000000000,306.003574325529712,2509.000000000000000,4,257,1,25.0000000,257,1,25.0000000,561,1108
1464,3.000000000000000,0.000208333333333,630,1393,763,1127.000000000000000,351.722428438487100,3381.000000000000000,3,630,1,33.3333015,630,1,33.3333015,1358,1393
1465,4.000000000000000,0.000277777777778,216,734,518,504.250000000000000,222.758136776190497,2017.000000000000000,4,216,1,25.0000000,216,1,25.0000000,359,734
1466,4.000000000000000,0.000277777777778,209,601,392,400.250000000000000,139.752236118067174,1601.000000000000000,4,209,1,25.0000000,209,1,25.0000000,371,601
1467,4.000000000000000,0.000277777777778,1250,1598,348,1420.000000000000000,135.773708795186081,5680.000000000000000,4,1250,1,25.0000000,1250,1,25.0000000,1335,1598
1468,4.000000000000000,0.000277777777778,896,1150,254,1017.250000000000000,95.805466963007930,4069.000000000000000,4,896,1,25.0000000,896,1,25.0000000,965,1150
1469,4.000000000000000,0.000277777777778,219,907,688,697.000000000000000,279.865146097187335,2788.000000000000000,4,219,1,25.0000000,219,1,25.0000000,782,907
1470,4.000000000000000,0.000277777777778,444,1599,1155,771.000000000000000,479.650393515944074,3084.000000000000000,4,444,1,25.0000000,444,1,25.0000000,487,1599
1471,4.000000000000000,0.000277777777778,161,824,663,425.750000000000000,264.412910993393041,1703.000000000000000,4,161,1,25.0000000,161,1,25.0000000,214,824
1472,3.000000000000000,0.000208333333333,1041,1497,456,1262.666666666666742,186.376560281120703,3788.000000000000000,3,1041,1,33.3333015,1041,1,33.3333015,1250,1497
1473,4.000000000000000,0.000277777777778,470,922,452,642.000000000000000,169.016271406039493,2568.000000000000000,4,470,1,25.0000000,470,1,25.0000000,573,922
1474,4.000000000000000,0.000277777777778,695,1391,696,1200.250000000000000,292.232249247067159,4801.000000000000000,4,695,1,25.0000000,695,1,25.0000000,1342,1391
1475,5.000000000000000,0.000347222222222,438,1562,1124,1199.400000000000091,392.098763068694211,5997.000000000000000,5,438,1,20.0000000,438,1,20.0000000,1322,1562
1476,4.000000000000000,0.000277777777778,65,1046,981,455.000000000000000,361.339867714593595,1820.000000000000000,4,65,1,25.0000000,65,1,25.0000000,336,1046
1477,4.000000000000000,0.000277777777778,237,1046,809,498.000000000000000,320.270979016207434,1992.000000000000000,4,237,1,25.0000000,237,1,25.0000000,336,1046
1478,5.000000000000000,0.000347222222222,849,1898,1049,1257.799999999999955,368.605697188743932,6289.000000000000000,5,849,1,20.0000000,849,1,20.0000000,1283,1898
1479,4.000000000000000,0.000277777777778,9,153,144,77.000000000000000,58.723930386172214,308.000000000000000,4,9,1,25.0000000,9,1,25.0000000,32,153
1480,4.000000000000000,0.000277777777778,625,767,142,694.750000000000000,53.853388937001910,2779.000000000000000,4,625,1,25.0000000,625,1,25.0000000,666,767
1481,4.000000000000000,0.000277777777778,844,1918,1074,1372.250000000000000,380.645750665891512,5489.000000000000000,4,844,1,25.0000000,844,1,25.0000000,1328,1918
1482,4.000000000000000,0.000277777777778,246,865,619,605.000000000000000,230.318258069133549,2420.000000000000000,4,246,1,25.0000000,246,1,25.0000000,581,865
1483,4.000000000000000,0.000277777777778,227,1458,1231,876.000000000000000,516.137094191068627,3504.000000000000000,4,227,1,25.0000000,227,1,25.0000000,520,1458
1484,4.000000000000000,0.000277777777778,227,1458,1231,876.000000000000000,516.137094191068627,3504.000000000000000,4,227,1,25.0000000,227,1,25.0000000,520,1458
1485,4.000000000000000,0.000277777777778,2,702,700,178.250000000000000,302.390786069946273,713.000000000000000,4,2,1,25.0000000,2,1,25.0000000,3,702
1486,4.000000000000000,0.000277777777778,243,789,546,400.250000000000000,225.385641734339430,1601.000000000000000,4,243,1,25.0000000,243,1,25.0000000,268,789
1487,4.000000000000000,0.000277777777778,618,1044,426,786.500000000000000,179.183565094569985,3146.000000000000000,4,618,1,25.0000000,618,1,25.0000000,620,1044
1488,4.000000000000000,0.000277777777778,432,2119,1687,1350.000000000000000,680.604510710882664,5400.000000000000000,4,432,1,25.0000000,432,1,25.0000000,973,2119
1489,4.000000000000000,0.000277777777778,1099,1472,373,1258.750000000000000,163.362136065858294,5035.000000000000000,4,1099,1,25.0000000,1099,1,25.0000000,1101,1472
1490,4.000000000000000,0.000277777777778,336,2095,1759,1166.500000000000000,816.272779161476137,4666.000000000000000,4,336,1,25.0000000,336,1,25.0000000,373,2095
1491,4.000000000000000,0.000277777777778,336,2095,1759,1060.500000000000000,743.345982702536730,4242.000000000000000,4,336,1,25.0000000,336,1,25.0000000,373,2095
1492,5.000000000000000,0.000347222222222,535,1542,1007,888.000000000000000,396.524904640301315,4440.000000000000000,5,535,1,20.0000000,535,1,20.0000000,659,1542
1493,4.000000000000000,0.000277777777778,742,3091,2349,1415.250000000000000,970.411607257456467,5661.000000000000000,4,742,1,25.0000000,742,1,25.0000000,876,3091
1494,5.000000000000000,0.000347222222222,655,2818,2163,1691.400000000000091,707.231673498861369,8457.000000000000000,5,655,1,20.0000000,655,1,20.0000000,1518,2818
1495,4.000000000000000,0.000277777777778,884,2567,1683,1402.500000000000000,688.709844564458081,5610.000000000000000,4,884,1,25.0000000,884,1,25.0000000,901,2567
1496,3.000000000000000,0.000208333333333,699,957,258,813.000000000000000,107.443008148506337,2439.000000000000000,3,699,1,33.3333015,699,1,33.3333015,783,957
1497,4.000000000000000,0.000277777777778,2430,5047,2617,3430.750000000000000,984.396610873889585,13723.000000000000000,4,2430,1,25.0000000,2430,1,25.0000000,2932,5047
1498,5.000000000000000,0.000347222222222,991,2663,1672,2002.799999999999955,645.450044542565706,10014.000000000000000,5,991,1,20.0000000,991,1,20.0000000,2213,2663
1499,5.000000000000000,0.000347222222222,1002,2217,1215,1635.400000000000091,449.361591594119204,8177.000000000000000,5,1002,1,20.0000000,1002,1,20.0000000,1535,2217
1500,4.000000000000000,0.000277777777778,752,1066,314,881.000000000000000,120.251819113059568,3524.000000000000000,4,752,1,25.0000000,752,1,25.0000000,801,1066
1501,4.000000000000000,0.000277777777778,302,1175,873,643.750000000000000,323.926206874343507,2575.000000000000000,4,302,1,25.0000000,302,1,25.0000000,512,1175
1502,4.000000000000000,0.000277777777778,443,524,81,481.000000000000000,35.517601270356089,1924.000000000000000,4,443,1,25.0000000,443,1,25.0000000,449,524
1503,4.000000000000000,0.000277777777778,731,1603,872,1027.000000000000000,350.853245674028244,4108.000000000000000,4,731,1,25.0000000,731,1,25.0000000,757,1603
1504,4.000000000000000,0.000277777777778,459,1017,558,766.250000000000000,201.051454856710762,3065.000000000000000,4,459,1,25.0000000,459,1,25.0000000,757,1017
1505,4.000000000000000,0.000277777777778,843,1210,367,1015.250000000000000,145.901293688575635,4061.000000000000000,4,843,1,25.0000000,843,1,25.0000000,911,1210
1506,4.000000000000000,0.000277777777778,720,1181,461,939.500000000000000,164.064773793767188,3758.000000000000000,4,720,1,25.0000000,720,1,25.0000000,907,1181
1507,4.000000000000000,0.000277777777778,494,1114,620,841.750000000000000,240.811518619853388,3367.000000000000000,4,494,1,25.0000000,494,1,25.0000000,749,1114
1508,4.000000000000000,0.000277777777778,621,1802,1181,1147.500000000000000,432.084771775169145,4590.000000000000000,4,621,1,25.0000000,621,1,25.0000000,955,1802
1509,3.000000000000000,0.000208333333333,1332,2032,700,1583.000000000000000,318.227382019000174,4749.000000000000000,3,1332,1,33.3333015,1332,1,33.3333015,1385,2032
1510,4.000000000000000,0.000277777777778,266,861,595,577.250000000000000,218.830270986442827,2309.000000000000000,4,266,1,25.0000000,266,1,25.0000000,508,861
1511,5.000000000000000,0.000347222222222,352,1625,1273,883.200000000000045,475.613035986189061,4416.000000000000000,5,352,1,20.0000000,352,1,20.0000000,766,1625
1512,4.000000000000000,0.000277777777778,0,3,3,1.250000000000000,1.299038105676658,5.000000000000000,3,0,2,50.0000000,2,1,25.0000000,0,3
1513,4.000000000000000,0.000277777777778,58,513,455,227.750000000000000,180.714380999410224,911.000000000000000,4,58,1,25.0000000,58,1,25.0000000,87,513
1514,5.000000000000000,0.000347222222222,332,915,583,518.600000000000023,217.001935475239492,2593.000000000000000,5,332,1,20.0000000,332,1,20.0000000,407,915
1515,3.000000000000000,0.000208333333333,564,696,132,626.000000000000000,54.184868736576263,1878.000000000000000,3,564,1,33.3333015,564,1,33.3333015,618,696
1516,4.000000000000000,0.000277777777778,487,1345,858,789.000000000000000,330.263531138392580,3156.000000000000000,4,487,1,25.0000000,487,1,25.0000000,619,1345
1517,4.000000000000000,0.000277777777778,27,639,612,361.500000000000000,273.024266320779645,1446.000000000000000,4,27,1,25.0000000,27,1,25.0000000,158,639
1518,4.000000000000000,0.000277777777778,0,33,33,8.500000000000000,14.150971698084906,34.000000000000000,3,0,2,50.0000000,1,1,25.0000000,0,33
1519,4.000000000000000,0.000277777777778,370,2257,1887,939.250000000000000,765.101096261141151,3757.000000000000000,4,370,1,25.0000000,370,1,25.0000000,544,2257
1520,3.000000000000000,0.000208333333333,225,794,569,425.333333333333314,261.013835308058390,1276.000000000000000,3,225,1,33.3333015,225,1,33.3333015,257,794
1521,3.000000000000000,0.000208333333333,768,2246,1478,1486.000000000000000,604.121400603112761,4458.000000000000000,3,768,1,33.3333015,768,1,33.3333015,1444,2246
1522,4.000000000000000,0.000277777777778,202,767,565,539.000000000000000,238.892235118682748,2156.000000000000000,4,202,1,25.0000000,202,1,25.0000000,425,767
1523,4.000000000000000,0.000277777777778,860,1864,1004,1408.750000000000000,361.584965810250480,5635.000000000000000,4,860,1,25.0000000,860,1,25.0000000,1384,1864
1524,6.000000000000000,0.000416666666667,150,904,754,500.166666666666629,247.969364147177600,3001.000000000000000,6,150,1,16.6667004,150,1,16.6667004,535,626
1525,4.000000000000000,0.000277777777778,331,842,511,618.250000000000000,208.779039896250111,2473.000000000000000,4,331,1,25.0000000,331,1,25.0000000,509,842
1526,3.000000000000000,0.000208333333333,956,1895,939,1403.000000000000000,384.663489299413470,4209.000000000000000,3,956,1,33.3333015,956,1,33.3333015,1358,1895
1527,4.000000000000000,0.000277777777778,9,111,102,55.750000000000000,36.601741761834234,223.000000000000000,4,9,1,25.0000000,9,1,25.0000000,45,111
1528,4.000000000000000,0.000277777777778,559,1429,870,829.500000000000000,355.771345108062349,3318.000000000000000,4,559,1,25.0000000,559,1,25.0000000,566,1429
1529,4.000000000000000,0.000277777777778,939,1401,462,1166.500000000000000,222.209923270766637,4666.000000000000000,4,939,1,25.0000000,939,1,25.0000000,950,1401
1530,4.000000000000000,0.000277777777778,599,1430,831,927.500000000000000,317.477951990370514,3710.000000000000000,4,599,1,25.0000000,599,1,25.0000000,723,1430
1531,4.000000000000000,0.000277777777778,442,1756,1314,1209.000000000000000,479.690004065125379,4836.000000000000000,4,442,1,25.0000000,442,1,25.0000000,1253,1756
1532,4.000000000000000,0.000277777777778,768,1428,660,1083.500000000000000,302.292490809811568,4334.000000000000000,4,768,1,25.0000000,768,1,25.0000000,798,1428
1533,4.000000000000000,0.000277777777778,350,526,176,445.750000000000000,77.538296989294267,1783.000000000000000,4,350,1,25.0000000,350,1,25.0000000,389,526
1534,3.000000000000000,0.000208333333333,758,2122,1364,1279.666666666666742,601.245559004157826,3839.000000000000000,3,758,1,33.3333015,758,1,33.3333015,959,2122
1535,4.000000000000000,0.000277777777778,844,1918,1074,1372.250000000000000,380.645750665891512,5489.000000000000000,4,844,1,25.0000000,844,1,25.0000000,1328,1918
1536,4.000000000000000,0.000277777777778,752,2785,2033,1368.750000000000000,832.684926908131388,5475.000000000000000,4,752,1,25.0000000,752,1,25.0000000,785,2785
1537,4.000000000000000,0.000277777777778,113,1076,963,552.750000000000000,361.198266191852042,2211.000000000000000,4,113,1,25.0000000,113,1,25.0000000,351,1076
1538,3.000000000000000,0.000208333333333,1093,2049,956,1654.666666666666742,407.827033053093373,4964.000000000000000,3,1093,1,33.3333015,1093,1,33.3333015,1822,2049
1539,4.000000000000000,0.000277777777778,923,1529,606,1363.250000000000000,255.033698753713708,5453.000000000000000,4,923,1,25.0000000,923,1,25.0000000,1476,1529
1540,4.000000000000000,0.000277777777778,216,433,217,304.750000000000000,80.238316906575250,1219.000000000000000,4,216,1,25.0000000,216,1,25.0000000,267,433
1541,4.000000000000000,0.000277777777778,310,7668,7358,2579.500000000000000,2966.397014898713678,10318.000000000000000,4,310,1,25.0000000,310,1,25.0000000,869,7668
1542,4.000000000000000,0.000277777777778,0,739,739,187.250000000000000,318.562690062725324,749.000000000000000,4,0,1,25.0000000,0,1,25.0000000,3,739
1543,4.000000000000000,0.000277777777778,0,739,739,185.750000000000000,319.420862656151485,743.000000000000000,4,0,1,25.0000000,0,1,25.0000000,1,739
1544,4.000000000000000,0.000277777777778,959,1544,585,1220.250000000000000,242.320423200356771,4881.000000000000000,4,959,1,25.0000000,959,1,25.0000000,1016,1544
1545,4.000000000000000,0.000277777777778,910,1431,521,1174.000000000000000,251.685319397059800,4696.000000000000000,4,910,1,25.0000000,910,1,25.0000000,935,1431
1546,5.000000000000000,0.000347222222222,343,1726,1383,1213.599999999999909,564.066166331575005,6068.000000000000000,5,343,1,20.0000000,343,1,20.0000000,1622,1726
1547,3.000000000000000,0.000208333333333,895,1654,759,1382.000000000000000,345.146345772340453,4146.000000000000000,3,895,1,33.3333015,895,1,33.3333015,1597,1654
1548,4.000000000000000,0.000277777777778,129,630,501,330.000000000000000,209.710514757844237,1320.000000000000000,4,129,1,25.0000000,129,1,25.0000000,138,630
1549,4.000000000000000,0.000277777777778,32,1677,1645,523.250000000000000,678.341866244447601,2093.000000000000000,4,32,1,25.0000000,32,1,25.0000000,36,1677
1550,3.000000000000000,0.000208333333333,4855,8557,3702,6367.666666666666060,1585.267450271054031,19103.000000000000000,3,4855,1,33.3333015,4855,1,33.3333015,5691,8557
1551,4.000000000000000,0.000277777777778,0,239,239,155.000000000000000,97.859593295700961,620.000000000000000,3,239,2,50.0000000,0,1,25.0000000,142,239
1552,4.000000000000000,0.000277777777778,46,12535,12489,3572.250000000000000,5191.925046406197907,14289.000000000000000,4,46,1,25.0000000,46,1,25.0000000,479,12535
1553,5.000000000000000,0.000347222222222,838,1136,298,992.799999999999955,122.026882284191799,4964.000000000000000,5,838,1,20.0000000,838,1,20.0000000,1034,1136
1554,5.000000000000000,0.000347222222222,240,702,462,541.799999999999955,171.303706906768383,2709.000000000000000,5,240,1,20.0000000,240,1,20.0000000,628,702
1555,4.000000000000000,0.000277777777778,138,1349,1211,618.000000000000000,456.638259457089305,2472.000000000000000,4,138,1,25.0000000,138,1,25.0000000,355,1349
1556,4.000000000000000,0.000277777777778,504,2046,1542,1179.500000000000000,590.986674976686800,4718.000000000000000,4,504,1,25.0000000,504,1,25.0000000,791,2046
1557,4.000000000000000,0.000277777777778,461,698,237,544.250000000000000,95.415866081066412,2177.000000000000000,4,461,1,25.0000000,461,1,25.0000000,468,698
1558,4.000000000000000,0.000277777777778,397,1219,822,795.000000000000000,297.640723020221117,3180.000000000000000,4,397,1,25.0000000,397,1,25.0000000,693,1219
1559,4.000000000000000,0.000277777777778,613,2018,1405,1089.500000000000000,557.995743711365549,4358.000000000000000,4,613,1,25.0000000,613,1,25.0000000,699,2018
1560,4.000000000000000,0.000277777777778,613,2018,1405,1089.500000000000000,557.995743711365549,4358.000000000000000,4,613,1,25.0000000,613,1,25.0000000,699,2018
1561,4.000000000000000,0.000277777777778,613,2018,1405,1089.500000000000000,557.995743711365549,4358.000000000000000,4,613,1,25.0000000,613,1,25.0000000,699,2018
1562,4.000000000000000,0.000277777777778,89,777,688,332.500000000000000,263.249406457070677,1330.000000000000000,4,89,1,25.0000000,89,1,25.0000000,224,777
1563,4.000000000000000,0.000277777777778,134,344,210,236.750000000000000,92.307570112098603,947.000000000000000,4,134,1,25.0000000,134,1,25.0000000,157,344
1564,5.000000000000000,0.000347222222222,204,790,586,544.000000000000000,233.208061610228214,2720.000000000000000,5,204,1,20.0000000,204,1,20.0000000,686,790
1565,4.000000000000000,0.000277777777778,17,991,974,352.000000000000000,376.495683906203681,1408.000000000000000,4,17,1,25.0000000,17,1,25.0000000,189,991
1566,4.000000000000000,0.000277777777778,866,1049,183,962.000000000000000,71.186375100857603,3848.000000000000000,4,866,1,25.0000000,866,1,25.0000000,925,1049
1567,4.000000000000000,0.000277777777778,72,2840,2768,998.750000000000114,1080.496037706756169,3995.000000000000000,4,72,1,25.0000000,72,1,25.0000000,505,2840
1568,4.000000000000000,0.000277777777778,72,2840,2768,998.750000000000114,1080.496037706756169,3995.000000000000000,4,72,1,25.0000000,72,1,25.0000000,505,2840
1569,5.000000000000000,0.000347222222222,616,990,374,744.200000000000045,134.821956668785958,3721.000000000000000,5,616,1,20.0000000,616,1,20.0000000,710,990
1570,4.000000000000000,0.000277777777778,5630,92484,86854,29518.250000000000000,36409.873416252077732,118073.000000000000000,4,5630,1,25.0000000,5630,1,25.0000000,8591,92484
1571,4.000000000000000,0.000277777777778,2250,3935,1685,2973.250000000000000,655.496519822950745,11893.000000000000000,4,2250,1,25.0000000,2250,1,25.0000000,2506,3935
1572,3.000000000000000,0.000208333333333,688,1126,438,868.333333333333371,186.987224756725624,2605.000000000000000,3,688,1,33.3333015,688,1,33.3333015,791,1126
1573,4.000000000000000,0.000277777777778,688,1126,438,852.250000000000000,164.314294874183133,3409.000000000000000,4,688,1,25.0000000,688,1,25.0000000,791,1126
1574,4.000000000000000,0.000277777777778,399,506,107,437.250000000000000,40.886275203300187,1749.000000000000000,4,399,1,25.0000000,399,1,25.0000000,418,506
1575,4.000000000000000,0.000277777777778,39,2079,2040,1168.250000000000000,749.520972021463876,4673.000000000000000,4,39,1,25.0000000,39,1,25.0000000,1034,2079
1576,4.000000000000000,0.000277777777778,1420,1891,471,1593.750000000000000,191.425409755340468,6375.000000000000000,4,1420,1,25.0000000,1420,1,25.0000000,1431,1891
1577,4.000000000000000,0.000277777777778,87,6257,6170,1880.500000000000000,2542.196933756313229,7522.000000000000000,4,87,1,25.0000000,87,1,25.0000000,320,6257
1578,4.000000000000000,0.000277777777778,760,1432,672,1044.000000000000000,276.832982139050785,4176.000000000000000,4,760,1,25.0000000,760,1,25.0000000,805,1432
1579,4.000000000000000,0.000277777777778,312,1178,866,727.250000000000000,366.782888777543690,2909.000000000000000,4,312,1,25.0000000,312,1,25.0000000,425,1178
1580,3.000000000000000,0.000208333333333,575,1180,605,930.666666666666629,258.181245553497888,2792.000000000000000,3,575,1,33.3333015,575,1,33.3333015,1037,1180
1581,4.000000000000000,0.000277777777778,282,4622,4340,1500.500000000000000,1806.356207950137559,6002.000000000000000,4,282,1,25.0000000,282,1,25.0000000,470,4622
1582,5.000000000000000,0.000347222222222,243,930,687,594.600000000000023,271.166812128623121,2973.000000000000000,5,243,1,20.0000000,243,1,20.0000000,483,930
1583,4.000000000000000,0.000277777777778,453,2302,1849,1557.500000000000000,730.264506874050426,6230.000000000000000,4,453,1,25.0000000,453,1,25.0000000,1354,2302
1584,4.000000000000000,0.000277777777778,453,2302,1849,1557.500000000000000,730.264506874050426,6230.000000000000000,4,453,1,25.0000000,453,1,25.0000000,1354,2302
1585,4.000000000000000,0.000277777777778,535,1143,608,884.000000000000000,229.871703347758739,3536.000000000000000,4,535,1,25.0000000,535,1,25.0000000,833,1143
1586,4.000000000000000,0.000277777777778,1358,1795,437,1517.000000000000000,166.962570655820940,6068.000000000000000,4,1358,1,25.0000000,1358,1,25.0000000,1427,1795
1587,4.000000000000000,0.000277777777778,567,890,323,795.500000000000000,133.117429362198834,3182.000000000000000,4,567,1,25.0000000,567,1,25.0000000,843,890
1588,3.000000000000000,0.000208333333333,178,1556,1378,1084.000000000000000,640.826549595650476,3252.000000000000000,3,178,1,33.3333015,178,1,33.3333015,1518,1556
1589,4.000000000000000,0.000277777777778,548,1476,928,1098.500000000000000,367.058918976231951,4394.000000000000000,4,548,1,25.0000000,548,1,25.0000000,987,1476
1590,3.000000000000000,0.000208333333333,93,337,244,235.000000000000000,103.550309833755037,705.000000000000000,3,93,1,33.3333015,93,1,33.3333015,275,337
1591,5.000000000000000,0.000347222222222,83,978,895,642.799999999999955,324.804187165128781,3214.000000000000000,5,83,1,20.0000000,83,1,20.0000000,711,978
1592,4.000000000000000,0.000277777777778,666,3720,3054,1586.250000000000000,1240.588645563065029,6345.000000000000000,4,666,1,25.0000000,666,1,25.0000000,879,3720
1593,4.000000000000000,0.000277777777778,383,1266,883,615.500000000000000,375.726296657553632,2462.000000000000000,4,383,1,25.0000000,383,1,25.0000000,399,1266
1594,4.000000000000000,0.000277777777778,562,1238,676,954.000000000000000,257.725629303722940,3816.000000000000000,4,562,1,25.0000000,562,1,25.0000000,895,1238
1595,4.000000000000000,0.000277777777778,548,1805,1257,1246.250000000000000,461.550850394623353,4985.000000000000000,4,548,1,25.0000000,548,1,25.0000000,1170,1805
1596,3.000000000000000,0.000208333333333,749,1436,687,1112.666666666666742,281.912910113901830,3338.000000000000000,3,749,1,33.3333015,749,1,33.3333015,1153,1436
1597,3.000000000000000,0.000208333333333,249,1200,951,825.000000000000000,413.441652473477802,2475.000000000000000,3,249,1,33.3333015,249,1,33.3333015,1026,1200
1598,3.000000000000000,0.000208333333333,357,778,421,515.666666666666629,186.851694013074336,1547.000000000000000,3,357,1,33.3333015,357,1,33.3333015,412,778
1599,4.000000000000000,0.000277777777778,76,502,426,206.250000000000000,174.336420463424673,825.000000000000000,4,76,1,25.0000000,76,1,25.0000000,82,502
1600,4.000000000000000,0.000277777777778,0,581,581,151.000000000000000,248.325391371885274,604.000000000000000,4,0,1,25.0000000,0,1,25.0000000,7,581
1601,4.000000000000000,0.000277777777778,168,923,755,585.250000000000000,271.281564983689975,2341.000000000000000,4,168,1,25.0000000,168,1,25.0000000,586,923
1602,3.000000000000000,0.000208333333333,35,388,353,178.000000000000000,151.699263896258458,534.000000000000000,3,35,1,33.3333015,35,1,33.3333015,111,388
1603,4.000000000000000,0.000277777777778,164,621,457,391.000000000000000,216.366587069260760,1564.000000000000000,4,164,1,25.0000000,164,1,25.0000000,186,621
1604,4.000000000000000,0.000277777777778,941,1450,509,1164.250000000000000,227.161148746875284,4657.000000000000000,4,941,1,25.0000000,941,1,25.0000000,942,1450
1605,4.000000000000000,0.000277777777778,1397,4690,3293,2621.500000000000000,1310.528996245409189,10486.000000000000000,4,1397,1,25.0000000,1397,1,25.0000000,1593,4690
1606,4.000000000000000,0.000277777777778,923,1748,825,1419.000000000000000,303.976150380256001,5676.000000000000000,4,923,1,25.0000000,923,1,25.0000000,1476,1748
1607,4.000000000000000,0.000277777777778,323,613,290,490.500000000000000,105.826508966326585,1962.000000000000000,4,323,1,25.0000000,323,1,25.0000000,494,613
1608,4.000000000000000,0.000277777777778,365,1610,1245,967.500000000000000,440.801826221262388,3870.000000000000000,4,365,1,25.0000000,365,1,25.0000000,930,1610
1609,4.000000000000000,0.000277777777778,1052,2509,1457,1642.750000000000000,597.420862960107911,6571.000000000000000,4,1052,1,25.0000000,1052,1,25.0000000,1124,2509
1610,4.000000000000000,0.000277777777778,25,1969,1944,634.250000000000000,794.359923145673292,2537.000000000000000,4,25,1,25.0000000,25,1,25.0000000,39,1969
1611,4.000000000000000,0.000277777777778,747,1728,981,1188.000000000000000,363.402669225199816,4752.000000000000000,4,747,1,25.0000000,747,1,25.0000000,1002,1728
1612,3.000000000000000,0.000208333333333,1176,2018,842,1539.000000000000000,353.395906409039583,4617.000000000000000,3,1176,1,33.3333015,1176,1,33.3333015,1423,2018
1613,3.000000000000000,0.000208333333333,877,1056,179,944.000000000000000,79.703617651061904,2832.000000000000000,3,877,1,33.3333015,877,1,33.3333015,899,1056
1614,4.000000000000000,0.000277777777778,6241,28451,22210,17205.000000000000000,8439.977132670443098,68820.000000000000000,4,6241,1,25.0000000,6241,1,25.0000000,12693,28451
1615,4.000000000000000,0.000277777777778,278,4607,4329,2047.750000000000000,1670.848792530311584,8191.000000000000000,4,278,1,25.0000000,278,1,25.0000000,887,4607
1616,4.000000000000000,0.000277777777778,446,824,378,602.000000000000000,149.370345115755839,2408.000000000000000,4,446,1,25.0000000,446,1,25.0000000,487,824
1617,4.000000000000000,0.000277777777778,485,700,215,586.750000000000000,86.563199455657823,2347.000000000000000,4,485,1,25.0000000,485,1,25.0000000,523,700
1618,4.000000000000000,0.000277777777778,716,1638,922,1129.000000000000000,361.406281074360948,4516.000000000000000,4,716,1,25.0000000,716,1,25.0000000,871,1638
1619,4.000000000000000,0.000277777777778,279,900,621,606.250000000000000,246.916357295339992,2425.000000000000000,4,279,1,25.0000000,279,1,25.0000000,465,900
1620,4.000000000000000,0.000277777777778,696,1760,1064,1025.500000000000000,427.221546741266309,4102.000000000000000,3,823,2,50.0000000,696,1,25.0000000,823,1760
1621,4.000000000000000,0.000277777777778,469,1650,1181,1024.750000000000000,554.662679022124166,4099.000000000000000,4,469,1,25.0000000,469,1,25.0000000,476,1650
1622,4.000000000000000,0.000277777777778,327,927,600,531.500000000000000,241.372637223029045,2126.000000000000000,4,327,1,25.0000000,327,1,25.0000000,345,927
1623,4.000000000000000,0.000277777777778,333,829,496,606.250000000000000,194.793961662059758,2425.000000000000000,4,333,1,25.0000000,333,1,25.0000000,517,829
1624,4.000000000000000,0.000277777777778,444,728,284,568.750000000000000,107.054600555043876,2275.000000000000000,4,444,1,25.0000000,444,1,25.0000000,505,728
1625,4.000000000000000,0.000277777777778,273,1802,1529,1260.750000000000000,605.936207450916413,5043.000000000000000,4,273,1,25.0000000,273,1,25.0000000,1260,1802
1626,4.000000000000000,0.000277777777778,102,1600,1498,592.250000000000000,595.179122197679249,2369.000000000000000,4,102,1,25.0000000,102,1,25.0000000,217,1600
1627,4.000000000000000,0.000277777777778,616,2326,1710,1313.750000000000000,625.064146708159910,5255.000000000000000,4,616,1,25.0000000,616,1,25.0000000,1126,2326
1628,4.000000000000000,0.000277777777778,599,1430,831,908.250000000000000,317.379406231721362,3633.000000000000000,4,599,1,25.0000000,599,1,25.0000000,723,1430
1629,4.000000000000000,0.000277777777778,83,526,443,267.000000000000000,161.097796384680578,1068.000000000000000,4,83,1,25.0000000,83,1,25.0000000,224,526
1630,5.000000000000000,0.000347222222222,440,7668,7228,2075.000000000000000,2801.952390744710556,10375.000000000000000,5,440,1,20.0000000,440,1,20.0000000,835,7668
1631,4.000000000000000,0.000277777777778,20,151,131,86.000000000000000,60.708319034544189,344.000000000000000,4,20,1,25.0000000,20,1,25.0000000,31,151
1632,5.000000000000000,0.000347222222222,20,1011,991,271.000000000000000,373.963099783922530,1355.000000000000000,5,20,1,20.0000000,20,1,20.0000000,142,1011
1633,4.000000000000000,0.000277777777778,463,686,223,525.500000000000000,92.861455943787576,2102.000000000000000,4,463,1,25.0000000,463,1,25.0000000,473,686
1634,5.000000000000000,0.000347222222222,844,899,55,870.200000000000045,21.103554203024657,4351.000000000000000,5,844,1,20.0000000,844,1,20.0000000,860,899
1635,3.000000000000000,0.000208333333333,761,2428,1667,1385.000000000000000,742.245691578379365,4155.000000000000000,3,761,1,33.3333015,761,1,33.3333015,966,2428
1636,3.000000000000000,0.000208333333333,761,2428,1667,1385.000000000000000,742.245691578379365,4155.000000000000000,3,761,1,33.3333015,761,1,33.3333015,966,2428
1637,4.000000000000000,0.000277777777778,248,1004,756,677.750000000000000,278.729595665763497,2711.000000000000000,4,248,1,25.0000000,248,1,25.0000000,645,1004
1638,4.000000000000000,0.000277777777778,1051,2212,1161,1669.250000000000000,427.639670166367978,6677.000000000000000,4,1051,1,25.0000000,1051,1,25.0000000,1546,2212
1639,4.000000000000000,0.000277777777778,1015,1821,806,1401.000000000000000,285.502189133463617,5604.000000000000000,4,1015,1,25.0000000,1015,1,25.0000000,1378,1821
1640,4.000000000000000,0.000277777777778,1257,1821,564,1461.500000000000000,213.977218413549821,5846.000000000000000,4,1257,1,25.0000000,1257,1,25.0000000,1378,1821
1641,3.000000000000000,0.000208333333333,1358,1427,69,1383.000000000000000,31.208973068654469,4149.000000000000000,3,1358,1,33.3333015,1358,1,33.3333015,1364,1427
1642,4.000000000000000,0.000277777777778,1163,1427,264,1328.000000000000000,99.022724664594037,5312.000000000000000,4,1163,1,25.0000000,1163,1,25.0000000,1358,1427
1643,4.000000000000000,0.000277777777778,329,995,666,656.750000000000000,270.625548498289447,2627.000000000000000,4,329,1,25.0000000,329,1,25.0000000,463,995
1644,4.000000000000000,0.000277777777778,329,995,666,656.750000000000000,270.625548498289447,2627.000000000000000,4,329,1,25.0000000,329,1,25.0000000,463,995
1645,4.000000000000000,0.000277777777778,370,1395,1025,907.250000000000000,386.314234141068141,3629.000000000000000,4,370,1,25.0000000,370,1,25.0000000,746,1395
1646,4.000000000000000,0.000277777777778,0,80,80,33.750000000000000,31.227992250543423,135.000000000000000,4,0,1,25.0000000,0,1,25.0000000,11,80
1647,4.000000000000000,0.000277777777778,622,788,166,698.500000000000000,62.279611431029345,2794.000000000000000,4,622,1,25.0000000,622,1,25.0000000,664,788
1648,4.000000000000000,0.000277777777778,914,3332,2418,1559.500000000000000,1024.838889777315217,6238.000000000000000,4,914,1,25.0000000,914,1,25.0000000,934,3332
1649,4.000000000000000,0.000277777777778,524,1000,476,667.500000000000000,196.093727589640139,2670.000000000000000,3,524,2,50.0000000,622,1,25.0000000,524,1000
1650,4.000000000000000,0.000277777777778,524,1939,1415,996.750000000000000,577.674378434771825,3987.000000000000000,3,524,2,50.0000000,1000,1,25.0000000,524,1939
1651,5.000000000000000,0.000347222222222,712,8670,7958,3706.400000000000091,2688.724203037567349,18532.000000000000000,5,712,1,20.0000000,712,1,20.0000000,2885,8670
1652,4.000000000000000,0.000277777777778,658,2171,1513,1466.000000000000000,604.835928165647260,5864.000000000000000,4,658,1,25.0000000,658,1,25.0000000,1125,2171
1653,4.000000000000000,0.000277777777778,397,1219,822,795.000000000000000,297.640723020221117,3180.000000000000000,4,397,1,25.0000000,397,1,25.0000000,693,1219
1654,4.000000000000000,0.000277777777778,1158,2864,1706,1955.750000000000000,681.085301192148791,7823.000000000000000,4,1158,1,25.0000000,1158,1,25.0000000,1460,2864
1655,4.000000000000000,0.000277777777778,481,2022,1541,999.499999999999886,609.276004779443156,3998.000000000000000,4,481,1,25.0000000,481,1,25.0000000,600,2022
1656,4.000000000000000,0.000277777777778,66,910,844,412.500000000000000,333.896316242033436,1650.000000000000000,4,66,1,25.0000000,66,1,25.0000000,154,910
1657,4.000000000000000,0.000277777777778,365,837,472,590.500000000000000,167.865273359322288,2362.000000000000000,4,365,1,25.0000000,365,1,25.0000000,559,837
1658,4.000000000000000,0.000277777777778,780,3558,2778,1562.500000000000000,1154.340829218130011,6250.000000000000000,3,956,2,50.0000000,780,1,25.0000000,956,3558
1659,4.000000000000000,0.000277777777778,780,3558,2778,1562.500000000000000,1154.340829218130011,6250.000000000000000,3,956,2,50.0000000,780,1,25.0000000,956,3558
1660,4.000000000000000,0.000277777777778,374,1292,918,957.750000000000000,360.483269375986481,3831.000000000000000,4,374,1,25.0000000,374,1,25.0000000,948,1292
1661,4.000000000000000,0.000277777777778,1079,4693,3614,2281.000000000000000,1413.765892925699291,9124.000000000000000,4,1079,1,25.0000000,1079,1,25.0000000,1663,4693
1662,4.000000000000000,0.000277777777778,275,1072,797,819.250000000000000,319.794758399821205,3277.000000000000000,4,275,1,25.0000000,275,1,25.0000000,908,1072
1663,4.000000000000000,0.000277777777778,119,752,633,485.750000000000000,233.134483721306225,1943.000000000000000,4,119,1,25.0000000,119,1,25.0000000,477,752
1664,4.000000000000000,0.000277777777778,134,709,575,438.250000000000000,204.686803433929271,1753.000000000000000,4,134,1,25.0000000,134,1,25.0000000,431,709
1665,4.000000000000000,0.000277777777778,0,1273,1273,498.000000000000000,535.134095344335151,1992.000000000000000,3,0,2,50.0000000,719,1,25.0000000,0,1273
1666,5.000000000000000,0.000347222222222,47,348,301,145.400000000000006,111.840243204313538,727.000000000000000,4,47,2,40.0000000,110,1,20.0000000,110,348
1667,4.000000000000000,0.000277777777778,221,500,279,338.000000000000000,107.291658576051475,1352.000000000000000,4,221,1,25.0000000,221,1,25.0000000,265,500
1668,5.000000000000000,0.000347222222222,203,938,735,492.199999999999989,254.959133980330279,2461.000000000000000,5,203,1,20.0000000,203,1,20.0000000,450,938
1669,4.000000000000000,0.000277777777778,784,3510,2726,2073.250000000000000,1049.047037791919138,8293.000000000000000,4,784,1,25.0000000,784,1,25.0000000,1423,3510
1670,4.000000000000000,0.000277777777778,260,510,250,414.500000000000000,93.782994194043511,1658.000000000000000,4,260,1,25.0000000,260,1,25.0000000,429,510
1671,4.000000000000000,0.000277777777778,2940,10718,7778,6027.000000000000000,2883.390799041989339,24108.000000000000000,4,2940,1,25.0000000,2940,1,25.0000000,4759,10718
1672,5.000000000000000,0.000347222222222,3138,10718,7580,6595.399999999999636,2704.881557480844549,32977.000000000000000,5,3138,1,20.0000000,3138,1,20.0000000,5691,10718
1673,4.000000000000000,0.000277777777778,569,1486,917,1182.750000000000000,368.390672384630307,4731.000000000000000,4,569,1,25.0000000,569,1,25.0000000,1224,1486
1674,3.000000000000000,0.000208333333333,1383,1626,243,1471.333333333333258,109.734021869042749,4414.000000000000000,3,1383,1,33.3333015,1383,1,33.3333015,1405,1626
1675,4.000000000000000,0.000277777777778,150,1758,1608,957.250000000000000,576.896600353997542,3829.000000000000000,4,150,1,25.0000000,150,1,25.0000000,822,1758
1676,5.000000000000000,0.000347222222222,395,1641,1246,867.600000000000023,459.393339089717301,4338.000000000000000,5,395,1,20.0000000,395,1,20.0000000,927,1641
1677,4.000000000000000,0.000277777777778,657,1052,395,894.000000000000000,145.136142983062655,3576.000000000000000,4,657,1,25.0000000,657,1,25.0000000,932,1052
1678,4.000000000000000,0.000277777777778,546,748,202,646.000000000000000,86.101684071799681,2584.000000000000000,4,546,1,25.0000000,546,1,25.0000000,577,748
1679,4.000000000000000,0.000277777777778,674,1378,704,1103.000000000000000,285.470663991941535,4412.000000000000000,4,674,1,25.0000000,674,1,25.0000000,1015,1378
1680,3.000000000000000,0.000208333333333,245,963,718,517.333333333333258,317.715106485179376,1552.000000000000000,3,245,1,33.3333015,245,1,33.3333015,344,963
1681,4.000000000000000,0.000277777777778,460,1145,685,856.750000000000000,254.394747390743134,3427.000000000000000,4,460,1,25.0000000,460,1,25.0000000,832,1145
1682,4.000000000000000,0.000277777777778,57,859,802,435.000000000000000,325.603286224202577,1740.000000000000000,4,57,1,25.0000000,57,1,25.0000000,188,859
1683,3.000000000000000,0.000208333333333,333,948,615,702.000000000000000,265.710368634722272,2106.000000000000000,3,333,1,33.3333015,333,1,33.3333015,825,948
1684,4.000000000000000,0.000277777777778,1231,2862,1631,1966.250000000000000,582.245813638878872,7865.000000000000000,4,1231,1,25.0000000,1231,1,25.0000000,1876,2862
1685,5.000000000000000,0.000347222222222,1022,2028,1006,1598.799999999999955,363.171254369064854,7994.000000000000000,5,1022,1,20.0000000,1022,1,20.0000000,1610,2028
1686,5.000000000000000,0.000347222222222,1986,3588,1602,2751.599999999999909,525.205712078610190,13758.000000000000000,5,1986,1,20.0000000,1986,1,20.0000000,2707,3588
1687,4.000000000000000,0.000277777777778,944,1898,954,1360.000000000000000,342.948246824502689,5440.000000000000000,4,944,1,25.0000000,944,1,25.0000000,1283,1898
1688,3.000000000000000,0.000208333333333,735,1308,573,930.000000000000000,267.331255187267629,2790.000000000000000,3,735,1,33.3333015,735,1,33.3333015,747,1308
1689,4.000000000000000,0.000277777777778,47,524,477,213.250000000000000,185.038340621612804,853.000000000000000,4,47,1,25.0000000,47,1,25.0000000,107,524
1690,4.000000000000000,0.000277777777778,503,1594,1091,1200.750000000000000,426.013130666180302,4803.000000000000000,4,503,1,25.0000000,503,1,25.0000000,1215,1594
1691,4.000000000000000,0.000277777777778,203,2219,2016,1006.499999999999886,779.302733217329319,4026.000000000000000,4,203,1,25.0000000,203,1,25.0000000,463,2219
1692,4.000000000000000,0.000277777777778,747,1186,439,1001.500000000000000,160.966611444734099,4006.000000000000000,4,747,1,25.0000000,747,1,25.0000000,1002,1186
1693,5.000000000000000,0.000347222222222,351,1542,1191,1038.400000000000091,428.120824067225215,5192.000000000000000,5,351,1,20.0000000,351,1,20.0000000,1076,1542
1694,4.000000000000000,0.000277777777778,1032,8010,6978,3218.000000000000000,2821.592103759861402,12872.000000000000000,4,1032,1,25.0000000,1032,1,25.0000000,1320,8010
1695,3.000000000000000,0.000208333333333,280,790,510,594.333333333333258,224.479150232017957,1783.000000000000000,3,280,1,33.3333015,280,1,33.3333015,713,790
1696,4.000000000000000,0.000277777777778,776,5730,4954,2335.000000000000000,1999.046397660644516,9340.000000000000000,4,776,1,25.0000000,776,1,25.0000000,1003,5730
1697,4.000000000000000,0.000277777777778,168,1758,1590,1064.000000000000000,581.975514948867954,4256.000000000000000,4,168,1,25.0000000,168,1,25.0000000,1007,1758
1698,4.000000000000000,0.000277777777778,1098,1688,590,1418.750000000000000,217.751435127302898,5675.000000000000000,4,1098,1,25.0000000,1098,1,25.0000000,1364,1688
1699,4.000000000000000,0.000277777777778,1098,1688,590,1418.750000000000000,217.751435127302898,5675.000000000000000,4,1098,1,25.0000000,1098,1,25.0000000,1364,1688
1700,4.000000000000000,0.000277777777778,406,1527,1121,1045.750000000000000,407.829851163447813,4183.000000000000000,4,406,1,25.0000000,406,1,25.0000000,1048,1527
1701,4.000000000000000,0.000277777777778,39,528,489,170.250000000000000,206.987167476633687,681.000000000000000,4,39,1,25.0000000,39,1,25.0000000,41,528
1702,3.000000000000000,0.000208333333333,895,1361,466,1064.000000000000000,210.676687525380146,3192.000000000000000,3,895,1,33.3333015,895,1,33.3333015,936,1361
1703,4.000000000000000,0.000277777777778,576,682,106,617.000000000000000,42.059481689626189,2468.000000000000000,4,576,1,25.0000000,576,1,25.0000000,584,682
1704,4.000000000000000,0.000277777777778,673,773,100,722.500000000000000,37.825256112814358,2890.000000000000000,4,673,1,25.0000000,673,1,25.0000000,703,773
1705,4.000000000000000,0.000277777777778,313,859,546,530.250000000000000,207.366071236352440,2121.000000000000000,4,313,1,25.0000000,313,1,25.0000000,402,859
1706,3.000000000000000,0.000208333333333,287,1591,1304,799.000000000000000,567.981220346823306,2397.000000000000000,3,287,1,33.3333015,287,1,33.3333015,519,1591
1707,3.000000000000000,0.000208333333333,287,1591,1304,799.000000000000000,567.981220346823306,2397.000000000000000,3,287,1,33.3333015,287,1,33.3333015,519,1591
1708,4.000000000000000,0.000277777777778,310,7668,7358,2634.000000000000000,2933.419506309999178,10536.000000000000000,4,310,1,25.0000000,310,1,25.0000000,1226,7668
1709,3.000000000000000,0.000208333333333,430,623,193,548.333333333333371,84.625974473299593,1645.000000000000000,3,430,1,33.3333015,430,1,33.3333015,592,623
1710,4.000000000000000,0.000277777777778,665,867,202,766.500000000000000,88.536715547844892,3066.000000000000000,4,665,1,25.0000000,665,1,25.0000000,693,867
1711,4.000000000000000,0.000277777777778,624,2138,1514,1328.750000000000000,540.397712337866892,5315.000000000000000,4,624,1,25.0000000,624,1,25.0000000,1202,2138
1712,4.000000000000000,0.000277777777778,325,1650,1325,912.000000000000000,479.691046403828580,3648.000000000000000,4,325,1,25.0000000,325,1,25.0000000,737,1650
1713,5.000000000000000,0.000347222222222,329,943,614,592.600000000000023,251.731285302403421,2963.000000000000000,5,329,1,20.0000000,329,1,20.0000000,527,943
1714,4.000000000000000,0.000277777777778,642,2199,1557,1198.750000000000000,634.638627488116299,4795.000000000000000,4,642,1,25.0000000,642,1,25.0000000,659,2199
1715,4.000000000000000,0.000277777777778,1124,2374,1250,1770.250000000000000,442.848944336553643,7081.000000000000000,4,1124,1,25.0000000,1124,1,25.0000000,1765,2374
1716,4.000000000000000,0.000277777777778,444,674,230,533.750000000000000,85.148032860424905,2135.000000000000000,4,444,1,25.0000000,444,1,25.0000000,508,674
1717,4.000000000000000,0.000277777777778,740,2138,1398,1498.500000000000000,518.907747099616927,5994.000000000000000,4,740,1,25.0000000,740,1,25.0000000,1351,2138
1718,4.000000000000000,0.000277777777778,1376,2806,1430,1942.500000000000000,545.770327152365439,7770.000000000000000,4,1376,1,25.0000000,1376,1,25.0000000,1593,2806
1719,4.000000000000000,0.000277777777778,1376,2806,1430,1942.500000000000000,545.770327152365439,7770.000000000000000,4,1376,1,25.0000000,1376,1,25.0000000,1593,2806
1720,4.000000000000000,0.000277777777778,273,1484,1211,734.250000000000000,454.131795297356405,2937.000000000000000,4,273,1,25.0000000,273,1,25.0000000,525,1484
1721,4.000000000000000,0.000277777777778,676,5411,4735,2271.000000000000000,1843.832828647977067,9084.000000000000000,4,676,1,25.0000000,676,1,25.0000000,1469,5411
1722,4.000000000000000,0.000277777777778,1110,7013,5903,3160.000000000000000,2324.654705542309330,12640.000000000000000,4,1110,1,25.0000000,1110,1,25.0000000,1572,7013
1723,6.000000000000000,0.000416666666667,62,549,487,368.000000000000000,152.112896669984366,2208.000000000000000,6,62,1,16.6667004,62,1,16.6667004,365,470
1724,4.000000000000000,0.000277777777778,463,995,532,802.000000000000000,203.271985280805467,3208.000000000000000,4,463,1,25.0000000,463,1,25.0000000,840,995
1725,3.000000000000000,0.000208333333333,143,188,45,162.666666666666657,18.803073034893941,488.000000000000000,3,143,1,33.3333015,143,1,33.3333015,157,188
1726,4.000000000000000,0.000277777777778,473,7184,6711,2370.750000000000000,2798.074907414023983,9483.000000000000000,4,473,1,25.0000000,473,1,25.0000000,527,7184
1727,4.000000000000000,0.000277777777778,10,487,477,207.250000000000000,196.120339332767827,829.000000000000000,4,10,1,25.0000000,10,1,25.0000000,37,487
1728,5.000000000000000,0.000347222222222,10,610,600,287.800000000000011,238.167504080636519,1439.000000000000000,5,10,1,20.0000000,10,1,20.0000000,295,610
1729,4.000000000000000,0.000277777777778,10,295,285,134.750000000000000,116.911023860027839,539.000000000000000,4,10,1,25.0000000,10,1,25.0000000,37,295
1730,4.000000000000000,0.000277777777778,79,146,67,109.250000000000000,30.597181242722343,437.000000000000000,3,79,2,50.0000000,133,1,25.0000000,79,146
1731,4.000000000000000,0.000277777777778,107,393,286,257.500000000000000,101.394033355025385,1030.000000000000000,3,265,2,50.0000000,107,1,25.0000000,265,393
1732,4.000000000000000,0.000277777777778,406,1527,1121,1045.750000000000000,407.829851163447813,4183.000000000000000,4,406,1,25.0000000,406,1,25.0000000,1048,1527
1733,4.000000000000000,0.000277777777778,130,871,741,480.000000000000000,295.945096259424417,1920.000000000000000,4,130,1,25.0000000,130,1,25.0000000,267,871
1734,6.000000000000000,0.000416666666667,72,840,768,297.833333333333314,279.803155013583705,1787.000000000000000,6,72,1,16.6667004,72,1,16.6667004,118,491
1735,4.000000000000000,0.000277777777778,187,488,301,338.250000000000000,115.644660490659945,1353.000000000000000,4,187,1,25.0000000,187,1,25.0000000,275,488
1736,3.000000000000000,0.000208333333333,706,1146,440,883.333333333333371,189.492890514540306,2650.000000000000000,3,706,1,33.3333015,706,1,33.3333015,798,1146
1737,5.000000000000000,0.000347222222222,345,2915,2570,1429.599999999999909,1008.894761607968690,7148.000000000000000,5,345,1,20.0000000,345,1,20.0000000,1335,2915
1738,4.000000000000000,0.000277777777778,515,996,481,686.000000000000000,183.892631717532396,2744.000000000000000,4,515,1,25.0000000,515,1,25.0000000,605,996
1739,4.000000000000000,0.000277777777778,243,1146,903,646.000000000000000,326.028372998424800,2584.000000000000000,4,243,1,25.0000000,243,1,25.0000000,534,1146
1740,4.000000000000000,0.000277777777778,240,826,586,485.250000000000000,247.981224087631290,1941.000000000000000,4,240,1,25.0000000,240,1,25.0000000,257,826
1741,5.000000000000000,0.000347222222222,102,718,616,419.600000000000023,199.412737807794031,2098.000000000000000,5,102,1,20.0000000,102,1,20.0000000,446,718
1742,4.000000000000000,0.000277777777778,1758,12535,10777,5712.500000000000000,4109.930443450351049,22850.000000000000000,4,1758,1,25.0000000,1758,1,25.0000000,3482,12535
1743,4.000000000000000,0.000277777777778,2728,33553,30825,18234.250000000000000,14316.199187895508658,72937.000000000000000,4,2728,1,25.0000000,2728,1,25.0000000,5200,33553
1744,4.000000000000000,0.000277777777778,453,2302,1849,1557.500000000000000,730.264506874050426,6230.000000000000000,4,453,1,25.0000000,453,1,25.0000000,1354,2302
1745,4.000000000000000,0.000277777777778,453,2302,1849,1557.500000000000000,730.264506874050426,6230.000000000000000,4,453,1,25.0000000,453,1,25.0000000,1354,2302
1746,4.000000000000000,0.000277777777778,110,357,247,224.250000000000000,89.440972154823982,897.000000000000000,4,110,1,25.0000000,110,1,25.0000000,191,357
1747,5.000000000000000,0.000347222222222,302,937,635,558.600000000000023,210.940370721206421,2793.000000000000000,5,302,1,20.0000000,302,1,20.0000000,512,937
1748,4.000000000000000,0.000277777777778,512,937,425,645.500000000000000,170.321020429070927,2582.000000000000000,4,512,1,25.0000000,512,1,25.0000000,547,937
1749,4.000000000000000,0.000277777777778,152,361,209,242.750000000000000,76.352390270377256,971.000000000000000,4,152,1,25.0000000,152,1,25.0000000,210,361
1750,4.000000000000000,0.000277777777778,118,1259,1141,510.750000000000000,444.092543846437479,2043.000000000000000,4,118,1,25.0000000,118,1,25.0000000,257,1259
1751,4.000000000000000,0.000277777777778,653,3699,3046,1535.750000000000000,1254.162942962356965,6143.000000000000000,4,653,1,25.0000000,653,1,25.0000000,815,3699
1752,4.000000000000000,0.000277777777778,537,1326,789,891.750000000000000,283.187548278521604,3567.000000000000000,4,537,1,25.0000000,537,1,25.0000000,812,1326
1753,4.000000000000000,0.000277777777778,202,1226,1024,619.250000000000000,412.832517493474597,2477.000000000000000,4,202,1,25.0000000,202,1,25.0000000,278,1226
1754,4.000000000000000,0.000277777777778,2,1265,1263,459.750000000000000,487.888499044607499,1839.000000000000000,4,2,1,25.0000000,2,1,25.0000000,156,1265
1755,4.000000000000000,0.000277777777778,440,1322,882,893.000000000000000,312.525998918489961,3572.000000000000000,4,440,1,25.0000000,440,1,25.0000000,881,1322
1756,5.000000000000000,0.000347222222222,440,1322,882,874.000000000000000,282.102818135515975,4370.000000000000000,5,440,1,20.0000000,440,1,20.0000000,881,1322
1757,3.000000000000000,0.000208333333333,3531,9683,6152,6148.000000000000000,2594.072602427824677,18444.000000000000000,3,3531,1,33.3333015,3531,1,33.3333015,5230,9683
1758,5.000000000000000,0.000347222222222,277,782,505,589.200000000000045,177.929649018931087,2946.000000000000000,5,277,1,20.0000000,277,1,20.0000000,588,782
1759,4.000000000000000,0.000277777777778,1239,1674,435,1456.500000000000000,205.850066796199997,5826.000000000000000,4,1239,1,25.0000000,1239,1,25.0000000,1263,1674
1760,4.000000000000000,0.000277777777778,898,1650,752,1359.250000000000000,284.948569920959585,5437.000000000000000,4,898,1,25.0000000,898,1,25.0000000,1364,1650
1761,4.000000000000000,0.000277777777778,694,1130,436,901.000000000000000,165.562676953472817,3604.000000000000000,4,694,1,25.0000000,694,1,25.0000000,806,1130
1762,4.000000000000000,0.000277777777778,1758,12535,10777,5712.500000000000000,4109.930443450351049,22850.000000000000000,4,1758,1,25.0000000,1758,1,25.0000000,3482,12535
1763,4.000000000000000,0.000277777777778,235,1029,794,471.750000000000000,323.264114154355241,1887.000000000000000,4,235,1,25.0000000,235,1,25.0000000,306,1029
1764,5.000000000000000,0.000347222222222,160,1560,1400,603.200000000000045,493.622284748166578,3016.000000000000000,5,160,1,20.0000000,160,1,20.0000000,445,1560
1765,4.000000000000000,0.000277777777778,194,1248,1054,767.250000000000000,392.076124623777616,3069.000000000000000,4,194,1,25.0000000,194,1,25.0000000,654,1248
1766,4.000000000000000,0.000277777777778,262,985,723,538.250000000000000,297.406602986551036,2153.000000000000000,4,262,1,25.0000000,262,1,25.0000000,275,985
1767,5.000000000000000,0.000347222222222,646,1333,687,958.799999999999955,279.592131505877660,4794.000000000000000,5,646,1,20.0000000,646,1,20.0000000,842,1333
1768,4.000000000000000,0.000277777777778,228,562,334,417.000000000000000,127.869073665214302,1668.000000000000000,4,228,1,25.0000000,228,1,25.0000000,377,562
1769,3.000000000000000,0.000208333333333,0,1262,1262,609.000000000000000,516.147911617073873,1827.000000000000000,3,0,1,33.3333015,0,1,33.3333015,565,1262
1770,4.000000000000000,0.000277777777778,337,836,499,624.000000000000000,186.573041996961621,2496.000000000000000,4,337,1,25.0000000,337,1,25.0000000,594,836
1771,4.000000000000000,0.000277777777778,856,1328,472,1127.750000000000000,183.022368851460328,4511.000000000000000,4,856,1,25.0000000,856,1,25.0000000,1070,1328
1772,4.000000000000000,0.000277777777778,716,977,261,797.000000000000000,105.714237451726447,3188.000000000000000,4,716,1,25.0000000,716,1,25.0000000,727,977
1773,4.000000000000000,0.000277777777778,1759,7497,5738,5087.000000000000000,2080.555574840527697,20348.000000000000000,4,1759,1,25.0000000,1759,1,25.0000000,5476,7497
1774,4.000000000000000,0.000277777777778,150,626,476,390.500000000000000,197.819993933879175,1562.000000000000000,4,150,1,25.0000000,150,1,25.0000000,246,626
1775,5.000000000000000,0.000347222222222,242,1171,929,599.000000000000000,412.082030668652180,2995.000000000000000,5,242,1,20.0000000,242,1,20.0000000,304,1171
1776,4.000000000000000,0.000277777777778,626,1701,1075,1034.000000000000000,402.546270632333744,4136.000000000000000,4,626,1,25.0000000,626,1,25.0000000,864,1701
1777,4.000000000000000,0.000277777777778,434,491,57,450.500000000000000,23.584952830141511,1802.000000000000000,4,434,1,25.0000000,434,1,25.0000000,435,491
1778,4.000000000000000,0.000277777777778,26,910,884,402.500000000000000,344.552971254058434,1610.000000000000000,4,26,1,25.0000000,26,1,25.0000000,154,910
1779,4.000000000000000,0.000277777777778,1045,1167,122,1100.750000000000000,47.044526780487438,4403.000000000000000,4,1045,1,25.0000000,1045,1,25.0000000,1070,1167
1780,4.000000000000000,0.000277777777778,1265,2581,1316,1772.500000000000000,505.304116349748369,7090.000000000000000,4,1265,1,25.0000000,1265,1,25.0000000,1442,2581
1781,4.000000000000000,0.000277777777778,487,4640,4153,2154.750000000000000,1525.269545850830809,8619.000000000000000,4,487,1,25.0000000,487,1,25.0000000,1663,4640
1782,4.000000000000000,0.000277777777778,672,1180,508,894.500000000000000,185.224863341831082,3578.000000000000000,4,672,1,25.0000000,672,1,25.0000000,817,1180
1783,4.000000000000000,0.000277777777778,91,4161,4070,1267.750000000000000,1686.194439410829091,5071.000000000000000,4,91,1,25.0000000,91,1,25.0000000,141,4161
1784,4.000000000000000,0.000277777777778,898,2997,2099,1509.000000000000000,863.260389453842663,6036.000000000000000,4,898,1,25.0000000,898,1,25.0000000,1004,2997
1785,4.000000000000000,0.000277777777778,613,1282,669,938.250000000000000,253.930477690252843,3753.000000000000000,4,613,1,25.0000000,613,1,25.0000000,799,1282
1786,4.000000000000000,0.000277777777778,332,3719,3387,1845.250000000000000,1306.628940250444657,7381.000000000000000,4,332,1,25.0000000,332,1,25.0000000,971,3719
1787,5.000000000000000,0.000347222222222,137,609,472,276.199999999999989,168.941883498438585,1381.000000000000000,4,208,2,40.0000000,137,1,20.0000000,208,609
1788,3.000000000000000,0.000208333333333,1263,5234,3971,3212.000000000000000,1621.975544410786370,9636.000000000000000,3,1263,1,33.3333015,1263,1,33.3333015,3139,5234
1789,4.000000000000000,0.000277777777778,255,977,722,669.000000000000000,261.949422599096408,2676.000000000000000,4,255,1,25.0000000,255,1,25.0000000,686,977
1790,5.000000000000000,0.000347222222222,0,9,9,4.000000000000000,3.286335345030997,20.000000000000000,5,0,1,20.0000000,0,1,20.0000000,4,9
1791,4.000000000000000,0.000277777777778,653,956,303,830.000000000000000,131.059146952816690,3320.000000000000000,3,956,2,50.0000000,653,1,25.0000000,755,956
1792,4.000000000000000,0.000277777777778,343,1174,831,831.750000000000000,309.124064899515702,3327.000000000000000,4,343,1,25.0000000,343,1,25.0000000,817,1174
1793,3.000000000000000,0.000208333333333,413,2498,2085,1392.333333333333485,855.872394434798707,4177.000000000000000,3,413,1,33.3333015,413,1,33.3333015,1266,2498
1794,4.000000000000000,0.000277777777778,605,1319,714,884.250000000000000,290.059799868923562,3537.000000000000000,4,605,1,25.0000000,605,1,25.0000000,637,1319
1795,4.000000000000000,0.000277777777778,757,1603,846,1107.750000000000000,307.986505386193869,4431.000000000000000,4,757,1,25.0000000,757,1,25.0000000,1017,1603
1796,4.000000000000000,0.000277777777778,82,535,453,282.250000000000000,163.334587580218283,1129.000000000000000,4,82,1,25.0000000,82,1,25.0000000,230,535
1797,5.000000000000000,0.000347222222222,1047,4244,3197,2155.599999999999909,1178.207553871557820,10778.000000000000000,5,1047,1,20.0000000,1047,1,20.0000000,1510,4244
1798,5.000000000000000,0.000347222222222,12,710,698,389.000000000000000,245.640387558723745,1945.000000000000000,5,12,1,20.0000000,12,1,20.0000000,363,710
1799,4.000000000000000,0.000277777777778,695,2137,1442,1300.750000000000000,522.722859171090818,5203.000000000000000,4,695,1,25.0000000,695,1,25.0000000,1177,2137
1800,5.000000000000000,0.000347222222222,17,1599,1582,476.399999999999977,605.873122031337516,2382.000000000000000,5,17,1,20.0000000,17,1,20.0000000,91,1599
1801,3.000000000000000,0.000208333333333,137,331,194,256.333333333333314,85.265598116838561,769.000000000000000,3,137,1,33.3333015,137,1,33.3333015,301,331
1802,4.000000000000000,0.000277777777778,189,535,346,344.000000000000000,149.562695883699547,1376.000000000000000,4,189,1,25.0000000,189,1,25.0000000,207,535
1803,5.000000000000000,0.000347222222222,219,717,498,498.800000000000011,168.926492889658959,2494.000000000000000,5,219,1,20.0000000,219,1,20.0000000,546,717
1804,4.000000000000000,0.000277777777778,178,1982,1804,1308.500000000000000,677.639100111556445,5234.000000000000000,4,178,1,25.0000000,178,1,25.0000000,1518,1982
1805,4.000000000000000,0.000277777777778,322,932,610,633.500000000000000,247.336309505903330,2534.000000000000000,4,322,1,25.0000000,322,1,25.0000000,469,932
1806,3.000000000000000,0.000208333333333,782,1582,800,1055.666666666666515,372.272600239245264,3167.000000000000000,3,782,1,33.3333015,782,1,33.3333015,803,1582
1807,4.000000000000000,0.000277777777778,756,1912,1156,1251.500000000000000,443.080410309460660,5006.000000000000000,4,756,1,25.0000000,756,1,25.0000000,957,1912
1808,4.000000000000000,0.000277777777778,756,1912,1156,1251.500000000000000,443.080410309460660,5006.000000000000000,4,756,1,25.0000000,756,1,25.0000000,957,1912
1809,3.000000000000000,0.000208333333333,98,546,448,363.000000000000000,191.866272874277371,1089.000000000000000,3,98,1,33.3333015,98,1,33.3333015,445,546
1810,4.000000000000000,0.000277777777778,143,520,377,252.000000000000000,155.584382249633279,1008.000000000000000,4,143,1,25.0000000,143,1,25.0000000,157,520
1811,3.000000000000000,0.000208333333333,349,478,129,427.000000000000000,56.017854296643669,1281.000000000000000,3,349,1,33.3333015,349,1,33.3333015,454,478
1812,4.000000000000000,0.000277777777778,503,879,376,660.750000000000000,144.683058787129596,2643.000000000000000,4,503,1,25.0000000,503,1,25.0000000,562,879
1813,4.000000000000000,0.000277777777778,31,975,944,545.750000000000000,394.965425702047980,2183.000000000000000,4,31,1,25.0000000,31,1,25.0000000,296,975
1814,4.000000000000000,0.000277777777778,796,3131,2335,1462.000000000000000,966.945448306159733,5848.000000000000000,4,796,1,25.0000000,796,1,25.0000000,898,3131
1815,4.000000000000000,0.000277777777778,396,455,59,439.750000000000000,25.272267409158204,1759.000000000000000,3,455,2,50.0000000,396,1,25.0000000,453,455
1816,4.000000000000000,0.000277777777778,213,628,415,422.500000000000000,202.571592282827254,1690.000000000000000,4,213,1,25.0000000,213,1,25.0000000,227,628
1817,4.000000000000000,0.000277777777778,273,943,670,662.000000000000000,275.936586918081616,2648.000000000000000,4,273,1,25.0000000,273,1,25.0000000,531,943
1818,4.000000000000000,0.000277777777778,665,2609,1944,1381.250000000000000,736.582098275541853,5525.000000000000000,4,665,1,25.0000000,665,1,25.0000000,1028,2609
1819,4.000000000000000,0.000277777777778,731,1603,872,1021.000000000000000,351.178017535266576,4084.000000000000000,4,731,1,25.0000000,731,1,25.0000000,757,1603
1820,4.000000000000000,0.000277777777778,1590,4729,3139,2697.750000000000000,1204.192753465988972,10791.000000000000000,4,1590,1,25.0000000,1590,1,25.0000000,2134,4729
1821,3.000000000000000,0.000208333333333,591,848,257,711.000000000000000,105.606186687460053,2133.000000000000000,3,591,1,33.3333015,591,1,33.3333015,694,848
1822,4.000000000000000,0.000277777777778,24,843,819,370.500000000000000,324.353587925276372,1482.000000000000000,4,24,1,25.0000000,24,1,25.0000000,121,843
1823,4.000000000000000,0.000277777777778,817,1709,892,1437.500000000000000,360.763426638565988,5750.000000000000000,4,817,1,25.0000000,817,1,25.0000000,1590,1709
1824,4.000000000000000,0.000277777777778,587,1939,1352,1101.750000000000000,517.865511016132473,4407.000000000000000,4,587,1,25.0000000,587,1,25.0000000,775,1939
1825,4.000000000000000,0.000277777777778,205,560,355,405.000000000000000,134.273973650890355,1620.000000000000000,4,205,1,25.0000000,205,1,25.0000000,368,560
1826,4.000000000000000,0.000277777777778,449,4640,4191,1972.250000000000000,1617.111835186422695,7889.000000000000000,4,449,1,25.0000000,449,1,25.0000000,971,4640
1827,4.000000000000000,0.000277777777778,449,719,270,582.000000000000000,96.628153247384361,2328.000000000000000,4,449,1,25.0000000,449,1,25.0000000,559,719
1828,4.000000000000000,0.000277777777778,633,1504,871,1013.750000000000000,354.841073580835598,4055.000000000000000,4,633,1,25.0000000,633,1,25.0000000,722,1504
1829,4.000000000000000,0.000277777777778,140,714,574,363.000000000000000,231.241216049388584,1452.000000000000000,4,140,1,25.0000000,140,1,25.0000000,171,714
1830,5.000000000000000,0.000347222222222,743,3086,2343,1859.400000000000091,765.796996598968121,9297.000000000000000,5,743,1,20.0000000,743,1,20.0000000,1953,3086
1831,4.000000000000000,0.000277777777778,167,1065,898,549.750000000000000,325.718724515493591,2199.000000000000000,4,167,1,25.0000000,167,1,25.0000000,441,1065
1832,4.000000000000000,0.000277777777778,1012,1353,341,1238.000000000000000,135.486161654982311,4952.000000000000000,4,1012,1,25.0000000,1012,1,25.0000000,1255,1353
1833,4.000000000000000,0.000277777777778,1140,1577,437,1380.250000000000000,156.026239780365160,5521.000000000000000,3,1402,2,50.0000000,1140,1,25.0000000,1402,1577
1834,4.000000000000000,0.000277777777778,307,758,451,550.500000000000000,179.416415079557311,2202.000000000000000,4,307,1,25.0000000,307,1,25.0000000,455,758
1835,4.000000000000000,0.000277777777778,322,1494,1172,667.250000000000000,484.890387097950224,2669.000000000000000,3,322,2,50.0000000,531,1,25.0000000,322,1494
1836,4.000000000000000,0.000277777777778,34,145,111,85.000000000000000,40.329889660151572,340.000000000000000,4,34,1,25.0000000,34,1,25.0000000,69,145
1837,3.000000000000000,0.000208333333333,395,578,183,503.000000000000000,78.268767717397978,1509.000000000000000,3,395,1,33.3333015,395,1,33.3333015,536,578
1838,4.000000000000000,0.000277777777778,135,4081,3946,1711.500000000000000,1468.354436095045912,6846.000000000000000,4,135,1,25.0000000,135,1,25.0000000,991,4081
1839,3.000000000000000,0.000208333333333,872,1811,939,1409.000000000000000,395.051895325158512,4227.000000000000000,3,872,1,33.3333015,872,1,33.3333015,1544,1811
1840,4.000000000000000,0.000277777777778,872,1811,939,1464.750000000000000,355.490769922370816,5859.000000000000000,4,872,1,25.0000000,872,1,25.0000000,1544,1811
1841,4.000000000000000,0.000277777777778,235,800,565,472.250000000000000,240.772065447800657,1889.000000000000000,4,235,1,25.0000000,235,1,25.0000000,248,800
1842,4.000000000000000,0.000277777777778,409,1696,1287,1021.250000000000000,466.865277676547691,4085.000000000000000,4,409,1,25.0000000,409,1,25.0000000,849,1696
1843,4.000000000000000,0.000277777777778,87,663,576,408.000000000000000,223.071737340255623,1632.000000000000000,4,87,1,25.0000000,87,1,25.0000000,321,663
1844,4.000000000000000,0.000277777777778,711,1730,1019,1301.000000000000000,410.682967750063881,5204.000000000000000,4,711,1,25.0000000,711,1,25.0000000,1127,1730
1845,3.000000000000000,0.000208333333333,19,669,650,375.333333333333314,269.035726665107120,1126.000000000000000,3,19,1,33.3333015,19,1,33.3333015,438,669
1846,4.000000000000000,0.000277777777778,92,595,503,406.000000000000000,190.880852889963791,1624.000000000000000,4,92,1,25.0000000,92,1,25.0000000,426,595
1847,3.000000000000000,0.000208333333333,511,2396,1885,1167.333333333333485,869.475065133491285,3502.000000000000000,3,511,1,33.3333015,511,1,33.3333015,595,2396
1848,4.000000000000000,0.000277777777778,92,2396,2304,898.500000000000000,885.327199401441590,3594.000000000000000,4,92,1,25.0000000,92,1,25.0000000,511,2396
1849,4.000000000000000,0.000277777777778,654,1168,514,1002.500000000000000,208.131568965402238,4010.000000000000000,4,654,1,25.0000000,654,1,25.0000000,1032,1168
1850,4.000000000000000,0.000277777777778,255,577,322,443.750000000000000,117.459301462251176,1775.000000000000000,4,255,1,25.0000000,255,1,25.0000000,460,577
1851,4.000000000000000,0.000277777777778,482,1353,871,1058.500000000000000,339.133085970684931,4234.000000000000000,4,482,1,25.0000000,482,1,25.0000000,1175,1353
1852,4.000000000000000,0.000277777777778,482,1758,1276,1192.000000000000000,461.157782109333994,4768.000000000000000,4,482,1,25.0000000,482,1,25.0000000,1175,1758
1853,6.000000000000000,0.000416666666667,87,1772,1685,641.833333333333371,618.536287447138193,3851.000000000000000,5,275,2,33.3333015,87,1,16.6667004,275,1184
1854,3.000000000000000,0.000208333333333,546,2019,1473,1180.000000000000000,618.574166935542166,3540.000000000000000,3,546,1,33.3333015,546,1,33.3333015,975,2019
1855,4.000000000000000,0.000277777777778,477,1202,725,967.500000000000000,286.510471012840981,3870.000000000000000,4,477,1,25.0000000,477,1,25.0000000,1094,1202
1856,3.000000000000000,0.000208333333333,689,797,108,760.333333333333371,50.446891766380304,2281.000000000000000,3,689,1,33.3333015,689,1,33.3333015,795,797
1857,4.000000000000000,0.000277777777778,82,679,597,492.250000000000000,243.761538188451709,1969.000000000000000,4,82,1,25.0000000,82,1,25.0000000,535,679
1858,4.000000000000000,0.000277777777778,658,1178,520,941.250000000000000,238.131660011851466,3765.000000000000000,4,658,1,25.0000000,658,1,25.0000000,753,1178
1859,4.000000000000000,0.000277777777778,465,1394,929,729.750000000000000,384.463506070472192,2919.000000000000000,4,465,1,25.0000000,465,1,25.0000000,522,1394
1860,4.000000000000000,0.000277777777778,1037,1703,666,1329.500000000000000,249.985499579475601,5318.000000000000000,4,1037,1,25.0000000,1037,1,25.0000000,1185,1703
1861,4.000000000000000,0.000277777777778,989,2862,1873,1714.500000000000000,753.460848352454263,6858.000000000000000,4,989,1,25.0000000,989,1,25.0000000,1092,2862
1862,5.000000000000000,0.000347222222222,126,656,530,343.199999999999989,231.012900072701569,1716.000000000000000,5,126,1,20.0000000,126,1,20.0000000,212,656
1863,4.000000000000000,0.000277777777778,123,1433,1310,587.500000000000000,500.826566787346110,2350.000000000000000,4,123,1,25.0000000,123,1,25.0000000,390,1433
1864,5.000000000000000,0.000347222222222,774,1376,602,1081.799999999999955,249.566343884747397,5409.000000000000000,5,774,1,20.0000000,774,1,20.0000000,1170,1376
1865,6.000000000000000,0.000416666666667,95,1555,1460,450.833333333333371,521.512357369304254,2705.000000000000000,6,95,1,16.6667004,95,1,16.6667004,156,587
1866,4.000000000000000,0.000277777777778,536,1476,940,1012.000000000000000,364.634063137277394,4048.000000000000000,4,536,1,25.0000000,536,1,25.0000000,806,1476
1867,4.000000000000000,0.000277777777778,123,936,813,333.250000000000000,348.185564749603031,1333.000000000000000,3,123,2,50.0000000,151,1,25.0000000,123,936
1868,3.000000000000000,0.000208333333333,835,2153,1318,1374.000000000000000,564.199137421058708,4122.000000000000000,3,835,1,33.3333015,835,1,33.3333015,1134,2153
1869,4.000000000000000,0.000277777777778,310,2455,2145,923.500000000000000,888.422900425242347,3694.000000000000000,4,310,1,25.0000000,310,1,25.0000000,381,2455
1870,4.000000000000000,0.000277777777778,470,934,464,719.750000000000000,171.006396079211015,2879.000000000000000,4,470,1,25.0000000,470,1,25.0000000,674,934
1871,4.000000000000000,0.000277777777778,554,1050,496,770.250000000000000,182.951325493968483,3081.000000000000000,4,554,1,25.0000000,554,1,25.0000000,680,1050
1872,4.000000000000000,0.000277777777778,235,291,56,259.250000000000000,24.823124299733095,1037.000000000000000,3,235,2,50.0000000,276,1,25.0000000,235,291
1873,4.000000000000000,0.000277777777778,257,1170,913,673.750000000000000,335.765077844614439,2695.000000000000000,4,257,1,25.0000000,257,1,25.0000000,516,1170
1874,4.000000000000000,0.000277777777778,257,1170,913,673.750000000000000,335.765077844614439,2695.000000000000000,4,257,1,25.0000000,257,1,25.0000000,516,1170
1875,4.000000000000000,0.000277777777778,351,1542,1191,970.500000000000000,440.859671550936923,3882.000000000000000,4,351,1,25.0000000,351,1,25.0000000,813,1542
1876,4.000000000000000,0.000277777777778,110,767,657,578.250000000000000,273.288652344000582,2313.000000000000000,3,767,2,50.0000000,110,1,25.0000000,669,767
1877,4.000000000000000,0.000277777777778,69,702,633,292.500000000000000,242.874967833245421,1170.000000000000000,4,69,1,25.0000000,69,1,25.0000000,177,702
1878,4.000000000000000,0.000277777777778,729,4894,4165,2017.500000000000000,1684.606556439811584,8070.000000000000000,4,729,1,25.0000000,729,1,25.0000000,944,4894
1879,3.000000000000000,0.000208333333333,503,1060,557,804.666666666666629,229.742367785211854,2414.000000000000000,3,503,1,33.3333015,503,1,33.3333015,851,1060
1880,4.000000000000000,0.000277777777778,817,1709,892,1437.500000000000000,360.763426638565988,5750.000000000000000,4,817,1,25.0000000,817,1,25.0000000,1590,1709
1881,3.000000000000000,0.000208333333333,353,1471,1118,975.666666666666742,465.217750688379851,2927.000000000000000,3,353,1,33.3333015,353,1,33.3333015,1103,1471
1882,4.000000000000000,0.000277777777778,206,2158,1952,1252.000000000000000,904.095127738226438,5008.000000000000000,4,206,1,25.0000000,206,1,25.0000000,502,2158
1883,5.000000000000000,0.000347222222222,119,1202,1083,610.799999999999955,357.479733691296133,3054.000000000000000,5,119,1,20.0000000,119,1,20.0000000,629,1202
1884,4.000000000000000,0.000277777777778,191,1553,1362,658.750000000000000,532.726184357405145,2635.000000000000000,4,191,1,25.0000000,191,1,25.0000000,332,1553
1885,5.000000000000000,0.000347222222222,533,777,244,641.600000000000023,100.811904058994941,3208.000000000000000,5,533,1,20.0000000,533,1,20.0000000,596,777
1886,4.000000000000000,0.000277777777778,278,1042,764,786.750000000000000,300.259367047890805,3147.000000000000000,4,278,1,25.0000000,278,1,25.0000000,866,1042
1887,4.000000000000000,0.000277777777778,399,587,188,471.750000000000000,74.402200908306469,1887.000000000000000,4,399,1,25.0000000,399,1,25.0000000,414,587
1888,4.000000000000000,0.000277777777778,179,1168,989,699.250000000000000,379.937741610385444,2797.000000000000000,4,179,1,25.0000000,179,1,25.0000000,518,1168
1889,4.000000000000000,0.000277777777778,506,1035,529,756.250000000000000,208.575376063427001,3025.000000000000000,4,506,1,25.0000000,506,1,25.0000000,613,1035
1890,5.000000000000000,0.000347222222222,1,626,625,229.600000000000023,270.607169158542433,1148.000000000000000,5,1,1,20.0000000,1,1,20.0000000,24,626
1891,4.000000000000000,0.000277777777778,640,5915,5275,2096.000000000000000,2210.661778744093681,8384.000000000000000,4,640,1,25.0000000,640,1,25.0000000,754,5915
1892,4.000000000000000,0.000277777777778,817,2486,1669,1452.000000000000000,678.797834410216751,5808.000000000000000,4,817,1,25.0000000,817,1,25.0000000,871,2486
1893,4.000000000000000,0.000277777777778,363,654,291,467.000000000000000,111.186779789685417,1868.000000000000000,4,363,1,25.0000000,363,1,25.0000000,415,654
1894,4.000000000000000,0.000277777777778,118,539,421,328.500000000000000,198.862389606481401,1314.000000000000000,4,118,1,25.0000000,118,1,25.0000000,142,539
1895,4.000000000000000,0.000277777777778,342,1272,930,591.750000000000000,393.147793456862757,2367.000000000000000,4,342,1,25.0000000,342,1,25.0000000,361,1272
1896,4.000000000000000,0.000277777777778,340,790,450,654.000000000000000,183.530651390987003,2616.000000000000000,4,340,1,25.0000000,340,1,25.0000000,713,790
1897,4.000000000000000,0.000277777777778,327,790,463,650.750000000000000,189.093065711040794,2603.000000000000000,4,327,1,25.0000000,327,1,25.0000000,713,790
1898,4.000000000000000,0.000277777777778,629,1084,455,851.000000000000000,206.747430455616552,3404.000000000000000,4,629,1,25.0000000,629,1,25.0000000,662,1084
1899,4.000000000000000,0.000277777777778,427,659,232,505.000000000000000,91.019228737668385,2020.000000000000000,4,427,1,25.0000000,427,1,25.0000000,452,659
1900,5.000000000000000,0.000347222222222,437,896,459,655.600000000000023,152.819632246645597,3278.000000000000000,5,437,1,20.0000000,437,1,20.0000000,677,896
1901,4.000000000000000,0.000277777777778,305,943,638,592.750000000000000,291.124007082892433,2371.000000000000000,3,305,2,50.0000000,818,1,25.0000000,305,943
1902,5.000000000000000,0.000347222222222,15,1099,1084,433.399999999999977,396.276973845314387,2167.000000000000000,5,15,1,20.0000000,15,1,20.0000000,448,1099
1903,4.000000000000000,0.000277777777778,186,929,743,515.750000000000000,272.850119113039796,2063.000000000000000,4,186,1,25.0000000,186,1,25.0000000,388,929
1904,3.000000000000000,0.000208333333333,840,1371,531,1022.666666666666742,246.406619680198958,3068.000000000000000,3,840,1,33.3333015,840,1,33.3333015,857,1371
1905,4.000000000000000,0.000277777777778,327,1954,1627,1152.000000000000000,584.849980764298266,4608.000000000000000,4,327,1,25.0000000,327,1,25.0000000,1015,1954
1906,4.000000000000000,0.000277777777778,972,2915,1943,1852.250000000000000,838.656477647433462,7409.000000000000000,4,972,1,25.0000000,972,1,25.0000000,1093,2915
1907,5.000000000000000,0.000347222222222,912,2915,2003,1736.799999999999955,790.381275081843000,8684.000000000000000,5,912,1,20.0000000,912,1,20.0000000,1335,2915
1908,4.000000000000000,0.000277777777778,145,923,778,486.500000000000000,288.841219357625619,1946.000000000000000,4,145,1,25.0000000,145,1,25.0000000,334,923
1909,4.000000000000000,0.000277777777778,336,1578,1242,981.500000000000000,490.767511149627751,3926.000000000000000,4,336,1,25.0000000,336,1,25.0000000,698,1578
1910,4.000000000000000,0.000277777777778,266,632,366,518.000000000000000,149.088899653864246,2072.000000000000000,4,266,1,25.0000000,266,1,25.0000000,549,632
1911,4.000000000000000,0.000277777777778,484,1168,684,856.250000000000000,308.071724603216410,3425.000000000000000,4,484,1,25.0000000,484,1,25.0000000,620,1168
1912,4.000000000000000,0.000277777777778,305,943,638,651.000000000000000,284.414310469779252,2604.000000000000000,4,305,1,25.0000000,305,1,25.0000000,436,943
1913,5.000000000000000,0.000347222222222,319,678,359,557.000000000000000,147.459825037194463,2785.000000000000000,5,319,1,20.0000000,319,1,20.0000000,667,678
1914,4.000000000000000,0.000277777777778,436,1590,1154,928.500000000000000,421.279895081642849,3714.000000000000000,4,436,1,25.0000000,436,1,25.0000000,756,1590
1915,4.000000000000000,0.000277777777778,196,1562,1366,800.750000000000000,590.066680553986203,3203.000000000000000,4,196,1,25.0000000,196,1,25.0000000,256,1562
1916,4.000000000000000,0.000277777777778,787,1326,539,1079.750000000000000,191.983560494121463,4319.000000000000000,4,787,1,25.0000000,787,1,25.0000000,1101,1326
1917,4.000000000000000,0.000277777777778,339,788,449,606.500000000000000,173.808083816605034,2426.000000000000000,4,339,1,25.0000000,339,1,25.0000000,570,788
1918,4.000000000000000,0.000277777777778,512,937,425,645.500000000000000,170.321020429070927,2582.000000000000000,4,512,1,25.0000000,512,1,25.0000000,547,937
1919,4.000000000000000,0.000277777777778,17,955,938,329.250000000000000,382.135038304523960,1317.000000000000000,4,17,1,25.0000000,17,1,25.0000000,21,955
1920,4.000000000000000,0.000277777777778,1089,2375,1286,1478.500000000000000,524.971189685681679,5914.000000000000000,4,1089,1,25.0000000,1089,1,25.0000000,1129,2375
1921,5.000000000000000,0.000347222222222,101,1765,1664,753.799999999999955,683.567524096924899,3769.000000000000000,5,101,1,20.0000000,101,1,20.0000000,335,1765
1922,4.000000000000000,0.000277777777778,348,477,129,415.750000000000000,59.120110791506470,1663.000000000000000,4,348,1,25.0000000,348,1,25.0000000,366,477
1923,4.000000000000000,0.000277777777778,690,1175,485,915.500000000000000,209.093878437413849,3662.000000000000000,4,690,1,25.0000000,690,1,25.0000000,731,1175
1924,5.000000000000000,0.000347222222222,336,1314,978,815.000000000000000,314.401017810057340,4075.000000000000000,5,336,1,20.0000000,336,1,20.0000000,808,1314
1925,4.000000000000000,0.000277777777778,246,1191,945,661.750000000000000,338.893327612096869,2647.000000000000000,3,605,2,50.0000000,246,1,25.0000000,605,1191
1926,4.000000000000000,0.000277777777778,352,3566,3214,1367.750000000000000,1291.899449454174828,5471.000000000000000,4,352,1,25.0000000,352,1,25.0000000,539,3566
1927,4.000000000000000,0.000277777777778,350,938,588,728.000000000000000,228.329805325542196,2912.000000000000000,4,350,1,25.0000000,350,1,25.0000000,751,938
1928,4.000000000000000,0.000277777777778,232,699,467,549.500000000000000,185.815096265077443,2198.000000000000000,4,232,1,25.0000000,232,1,25.0000000,613,699
1929,5.000000000000000,0.000347222222222,375,586,211,475.000000000000000,73.764490101945398,2375.000000000000000,5,375,1,20.0000000,375,1,20.0000000,466,586
1930,4.000000000000000,0.000277777777778,41,724,683,416.250000000000000,302.833597046298678,1665.000000000000000,4,41,1,25.0000000,41,1,25.0000000,196,724
1931,3.000000000000000,0.000208333333333,529,1741,1212,1028.666666666666742,517.143650793041843,3086.000000000000000,3,529,1,33.3333015,529,1,33.3333015,816,1741
1932,3.000000000000000,0.000208333333333,530,829,299,719.333333333333371,134.437924543469336,2158.000000000000000,3,530,1,33.3333015,530,1,33.3333015,799,829
1933,4.000000000000000,0.000277777777778,219,1169,950,808.750000000000000,385.157354207342109,3235.000000000000000,4,219,1,25.0000000,219,1,25.0000000,712,1169
1934,4.000000000000000,0.000277777777778,914,3332,2418,1630.750000000000000,997.025921177579107,6523.000000000000000,4,914,1,25.0000000,914,1,25.0000000,934,3332
1935,4.000000000000000,0.000277777777778,161,824,663,425.750000000000000,264.412910993393041,1703.000000000000000,4,161,1,25.0000000,161,1,25.0000000,214,824
1936,4.000000000000000,0.000277777777778,841,2294,1453,1610.000000000000000,674.631380829560840,6440.000000000000000,4,841,1,25.0000000,841,1,25.0000000,1037,2294
1937,4.000000000000000,0.000277777777778,515,3299,2784,1370.500000000000000,1121.636639023529824,5482.000000000000000,4,515,1,25.0000000,515,1,25.0000000,781,3299
1938,4.000000000000000,0.000277777777778,454,1415,961,862.250000000000000,351.824796596260398,3449.000000000000000,4,454,1,25.0000000,454,1,25.0000000,711,1415
1939,4.000000000000000,0.000277777777778,775,1748,973,1032.500000000000000,413.385111004254725,4130.000000000000000,4,775,1,25.0000000,775,1,25.0000000,789,1748
1940,4.000000000000000,0.000277777777778,252,400,148,344.500000000000000,56.940758688306914,1378.000000000000000,4,252,1,25.0000000,252,1,25.0000000,345,400
1941,4.000000000000000,0.000277777777778,599,1430,831,908.250000000000000,317.379406231721362,3633.000000000000000,4,599,1,25.0000000,599,1,25.0000000,723,1430
1942,4.000000000000000,0.000277777777778,826,1432,606,1082.000000000000000,222.646580930406401,4328.000000000000000,4,826,1,25.0000000,826,1,25.0000000,981,1432
1943,5.000000000000000,0.000347222222222,742,2366,1624,1406.799999999999955,557.288937625716699,7034.000000000000000,5,742,1,20.0000000,742,1,20.0000000,1315,2366
1944,4.000000000000000,0.000277777777778,792,1206,414,940.000000000000000,162.041661309676783,3760.000000000000000,4,792,1,25.0000000,792,1,25.0000000,829,1206
1945,4.000000000000000,0.000277777777778,726,1541,815,1094.500000000000000,299.842041748651411,4378.000000000000000,4,726,1,25.0000000,726,1,25.0000000,952,1541
1946,4.000000000000000,0.000277777777778,179,1168,989,699.250000000000000,379.937741610385444,2797.000000000000000,4,179,1,25.0000000,179,1,25.0000000,518,1168
1947,5.000000000000000,0.000347222222222,392,797,405,581.600000000000023,175.690181854308520,2908.000000000000000,5,392,1,20.0000000,392,1,20.0000000,521,797
1948,4.000000000000000,0.000277777777778,300,1140,840,769.500000000000000,312.429592068357067,3078.000000000000000,4,300,1,25.0000000,300,1,25.0000000,701,1140
1949,4.000000000000000,0.000277777777778,1153,2650,1497,1988.250000000000000,548.428379553793661,7953.000000000000000,4,1153,1,25.0000000,1153,1,25.0000000,1913,2650
1950,4.000000000000000,0.000277777777778,1032,1183,151,1087.000000000000000,59.173473786824452,4348.000000000000000,4,1032,1,25.0000000,1032,1,25.0000000,1045,1183
1951,4.000000000000000,0.000277777777778,92,461,369,275.250000000000000,140.833900393335682,1101.000000000000000,4,92,1,25.0000000,92,1,25.0000000,199,461
1952,4.000000000000000,0.000277777777778,724,1333,609,1048.000000000000000,251.418973031074160,4192.000000000000000,4,724,1,25.0000000,724,1,25.0000000,886,1333
1953,4.000000000000000,0.000277777777778,1058,3324,2266,1650.750000000000000,967.001906668234142,6603.000000000000000,3,1058,2,50.0000000,1163,1,25.0000000,1058,3324
1954,4.000000000000000,0.000277777777778,2418,7122,4704,4891.500000000000000,2104.240183534189782,19566.000000000000000,4,2418,1,25.0000000,2418,1,25.0000000,3198,7122
1955,4.000000000000000,0.000277777777778,708,1716,1008,1247.000000000000000,359.211636782551864,4988.000000000000000,4,708,1,25.0000000,708,1,25.0000000,1242,1716
1956,4.000000000000000,0.000277777777778,414,1852,1438,1034.000000000000000,565.794574028418879,4136.000000000000000,4,414,1,25.0000000,414,1,25.0000000,613,1852
1957,6.000000000000000,0.000416666666667,841,1858,1017,1336.166666666666515,357.689071991614298,8017.000000000000000,6,841,1,16.6667004,841,1,16.6667004,1185,1703
1958,4.000000000000000,0.000277777777778,179,698,519,385.000000000000000,196.833686141371658,1540.000000000000000,4,179,1,25.0000000,179,1,25.0000000,265,698
1959,5.000000000000000,0.000347222222222,400,1922,1522,963.399999999999977,573.523007385056871,4817.000000000000000,5,400,1,20.0000000,400,1,20.0000000,644,1922
1960,4.000000000000000,0.000277777777778,763,1471,708,1107.500000000000000,319.732309909399078,4430.000000000000000,4,763,1,25.0000000,763,1,25.0000000,817,1471
1961,4.000000000000000,0.000277777777778,500,963,463,762.250000000000000,176.131165612449166,3049.000000000000000,4,500,1,25.0000000,500,1,25.0000000,712,963
1962,4.000000000000000,0.000277777777778,552,1896,1344,1274.000000000000000,482.303327792790526,5096.000000000000000,4,552,1,25.0000000,552,1,25.0000000,1231,1896
1963,4.000000000000000,0.000277777777778,836,1434,598,1014.500000000000000,243.477411683301739,4058.000000000000000,4,836,1,25.0000000,836,1,25.0000000,883,1434
1964,5.000000000000000,0.000347222222222,130,694,564,387.000000000000000,211.082922094611916,1935.000000000000000,5,130,1,20.0000000,130,1,20.0000000,438,694
1965,4.000000000000000,0.000277777777778,456,578,122,523.250000000000000,45.306594442751923,2093.000000000000000,4,456,1,25.0000000,456,1,25.0000000,512,578
1966,3.000000000000000,0.000208333333333,989,2862,1873,1922.000000000000000,764.665068292429964,5766.000000000000000,3,989,1,33.3333015,989,1,33.3333015,1915,2862
1967,4.000000000000000,0.000277777777778,518,1166,648,796.000000000000000,247.419683938040833,3184.000000000000000,4,518,1,25.0000000,518,1,25.0000000,635,1166
1968,4.000000000000000,0.000277777777778,1205,4669,3464,2198.250000000000000,1430.451567687630586,8793.000000000000000,4,1205,1,25.0000000,1205,1,25.0000000,1427,4669
1969,3.000000000000000,0.000208333333333,938,1662,724,1210.333333333333258,321.625385952180295,3631.000000000000000,3,938,1,33.3333015,938,1,33.3333015,1031,1662
1970,5.000000000000000,0.000347222222222,110,871,761,637.000000000000000,271.134652894092426,3185.000000000000000,5,110,1,20.0000000,110,1,20.0000000,767,871
1971,4.000000000000000,0.000277777777778,0,0,0,0.000000000000000,0.000000000000000,0.000000000000000,1,0,4,100.0000000,0,4,100.0000000,0,0
1972,5.000000000000000,0.000347222222222,69,567,498,297.000000000000000,198.841645537347119,1485.000000000000000,5,69,1,20.0000000,69,1,20.0000000,340,567
1973,4.000000000000000,0.000277777777778,264,843,579,525.000000000000000,218.328880361714852,2100.000000000000000,4,264,1,25.0000000,264,1,25.0000000,397,843
1974,4.000000000000000,0.000277777777778,273,806,533,537.500000000000000,188.574255931184837,2150.000000000000000,4,273,1,25.0000000,273,1,25.0000000,526,806
1975,4.000000000000000,0.000277777777778,283,978,695,768.500000000000000,286.194426919882574,3074.000000000000000,4,283,1,25.0000000,283,1,25.0000000,836,978
1976,4.000000000000000,0.000277777777778,1119,2247,1128,1665.750000000000000,399.725765369209114,6663.000000000000000,4,1119,1,25.0000000,1119,1,25.0000000,1619,2247
1977,4.000000000000000,0.000277777777778,0,2,2,0.500000000000000,0.866025403784439,2.000000000000000,2,0,3,75.0000000,2,1,25.0000000,0,2
1978,4.000000000000000,0.000277777777778,341,3021,2680,1233.750000000000000,1048.027045214005966,4935.000000000000000,4,341,1,25.0000000,341,1,25.0000000,754,3021
1979,4.000000000000000,0.000277777777778,567,957,390,750.250000000000000,153.064324713500753,3001.000000000000000,4,567,1,25.0000000,567,1,25.0000000,646,957
1980,4.000000000000000,0.000277777777778,475,3454,2979,1412.000000000000000,1214.901847887309714,5648.000000000000000,4,475,1,25.0000000,475,1,25.0000000,509,3454
1981,5.000000000000000,0.000347222222222,253,1972,1719,817.399999999999977,612.187095584348299,4087.000000000000000,5,253,1,20.0000000,253,1,20.0000000,672,1972
1982,4.000000000000000,0.000277777777778,756,1912,1156,1251.500000000000000,443.080410309460660,5006.000000000000000,4,756,1,25.0000000,756,1,25.0000000,957,1912
1983,4.000000000000000,0.000277777777778,2371,3947,1576,3242.750000000000000,650.074755316648179,12971.000000000000000,4,2371,1,25.0000000,2371,1,25.0000000,2868,3947
1984,4.000000000000000,0.000277777777778,578,988,410,857.750000000000000,167.750372577827676,3431.000000000000000,3,988,2,50.0000000,578,1,25.0000000,877,988
1985,4.000000000000000,0.000277777777778,302,937,635,584.250000000000000,228.757923360044515,2337.000000000000000,4,302,1,25.0000000,302,1,25.0000000,512,937
1986,4.000000000000000,0.000277777777778,923,971,48,947.000000000000000,24.000000000000000,3788.000000000000000,2,923,2,50.0000000,923,2,50.0000000,923,971
1987,3.000000000000000,0.000208333333333,817,981,164,875.333333333333371,74.852447447554383,2626.000000000000000,3,817,1,33.3333015,817,1,33.3333015,828,981
1988,4.000000000000000,0.000277777777778,128,729,601,405.500000000000000,279.399803149536979,1622.000000000000000,3,128,2,50.0000000,637,1,25.0000000,128,729
1989,4.000000000000000,0.000277777777778,72,475,403,248.250000000000000,146.248717943098569,993.000000000000000,4,72,1,25.0000000,72,1,25.0000000,193,475
1990,4.000000000000000,0.000277777777778,261,341,80,303.500000000000000,28.535066146760560,1214.000000000000000,4,261,1,25.0000000,261,1,25.0000000,302,341
1991,5.000000000000000,0.000347222222222,96,1116,1020,698.600000000000023,364.140412478483370,3493.000000000000000,5,96,1,20.0000000,96,1,20.0000000,717,1116
1992,4.000000000000000,0.000277777777778,948,2521,1573,1492.000000000000000,643.077367040700665,5968.000000000000000,3,948,2,50.0000000,1551,1,25.0000000,948,2521
1993,5.000000000000000,0.000347222222222,1246,2197,951,1868.599999999999909,350.020342265988916,9343.000000000000000,5,1246,1,20.0000000,1246,1,20.0000000,1972,2197
1994,4.000000000000000,0.000277777777778,220,2806,2586,1156.500000000000000,982.546309341193364,4626.000000000000000,4,220,1,25.0000000,220,1,25.0000000,731,2806
1995,3.000000000000000,0.000208333333333,549,572,23,564.333333333333371,10.842303978193728,1693.000000000000000,2,572,2,66.6667023,549,1,33.3333015,572,572
1996,4.000000000000000,0.000277777777778,432,755,323,600.750000000000000,149.017406701364933,2403.000000000000000,4,432,1,25.0000000,432,1,25.0000000,473,755
1997,4.000000000000000,0.000277777777778,146,942,796,416.000000000000000,314.823760221492819,1664.000000000000000,4,146,1,25.0000000,146,1,25.0000000,204,942
1998,3.000000000000000,0.000208333333333,541,1226,685,882.333333333333258,279.654946119121746,2647.000000000000000,3,541,1,33.3333015,541,1,33.3333015,880,1226
1999,4.000000000000000,0.000277777777778,0,10,10,3.000000000000000,4.123105625617661,12.000000000000000,3,0,2,50.0000000,2,1,25.0000000,0,10
2000,4.000000000000000,0.000277777777778,354,1425,1071,924.000000000000000,411.219527746433755,3696.000000000000000,4,354,1,25.0000000,354,1,25.0000000,737,1425
2001,4.000000000000000,0.000277777777778,446,7304,6858,3605.500000000000000,2594.542589744866746,14422.000000000000000,4,446,1,25.0000000,446,1,25.0000000,2087,7304
2002,4.000000000000000,0.000277777777778,232,1083,851,795.750000000000000,339.338603020640733,3183.000000000000000,4,232,1,25.0000000,232,1,25.0000000,829,1083
2003,4.000000000000000,0.000277777777778,768,1095,327,989.750000000000000,130.474853899132597,3959.000000000000000,4,768,1,25.0000000,768,1,25.0000000,1025,1095
2004,4.000000000000000,0.000277777777778,0,110,110,27.500000000000000,47.631397208144122,110.000000000000000,2,0,3,75.0000000,110,1,25.0000000,0,110
2005,4.000000000000000,0.000277777777778,415,645,230,492.500000000000000,91.141373700422136,1970.000000000000000,4,415,1,25.0000000,415,1,25.0000000,431,645
2006,4.000000000000000,0.000277777777778,30,1599,1569,1001.750000000000000,600.067235816120842,4007.000000000000000,4,30,1,25.0000000,30,1,25.0000000,1003,1599
2007,4.000000000000000,0.000277777777778,407,678,271,560.250000000000000,120.395961311000789,2241.000000000000000,3,678,2,50.0000000,407,1,25.0000000,478,678
2008,4.000000000000000,0.000277777777778,236,1025,789,576.250000000000000,290.034803946009220,2305.000000000000000,4,236,1,25.0000000,236,1,25.0000000,440,1025
2009,4.000000000000000,0.000277777777778,62,1469,1407,435.000000000000000,597.548742781708143,1740.000000000000000,4,62,1,25.0000000,62,1,25.0000000,77,1469
2010,4.000000000000000,0.000277777777778,214,1157,943,867.250000000000000,387.325686599791595,3469.000000000000000,3,1157,2,50.0000000,214,1,25.0000000,941,1157
2011,4.000000000000000,0.000277777777778,207,1249,1042,907.750000000000000,421.288128838209786,3631.000000000000000,4,207,1,25.0000000,207,1,25.0000000,950,1249
2012,4.000000000000000,0.000277777777778,741,1716,975,1118.750000000000000,393.514532768486220,4475.000000000000000,4,741,1,25.0000000,741,1,25.0000000,790,1716
2013,4.000000000000000,0.000277777777778,466,673,207,572.500000000000000,73.778384368322932,2290.000000000000000,4,466,1,25.0000000,466,1,25.0000000,563,673
2014,4.000000000000000,0.000277777777778,32,267,235,194.500000000000000,95.938782564716760,778.000000000000000,4,32,1,25.0000000,32,1,25.0000000,216,267
2015,5.000000000000000,0.000347222222222,245,1795,1550,963.600000000000023,501.915769825973939,4818.000000000000000,5,245,1,20.0000000,245,1,20.0000000,958,1795
2016,4.000000000000000,0.000277777777778,322,1713,1391,999.250000000000000,547.716338536655257,3997.000000000000000,4,322,1,25.0000000,322,1,25.0000000,641,1713
2017,4.000000000000000,0.000277777777778,622,1149,527,802.250000000000000,204.075200600170916,3209.000000000000000,3,719,2,50.0000000,622,1,25.0000000,719,1149
2018,4.000000000000000,0.000277777777778,0,0,0,0.000000000000000,0.000000000000000,0.000000000000000,1,0,4,100.0000000,0,4,100.0000000,0,0
2019,4.000000000000000,0.000277777777778,152,366,214,306.750000000000000,89.586201504472768,1227.000000000000000,4,152,1,25.0000000,152,1,25.0000000,348,366
2020,4.000000000000000,0.000277777777778,234,4640,4406,1527.750000000000000,1806.096948532940814,6111.000000000000000,4,234,1,25.0000000,234,1,25.0000000,487,4640
2021,3.000000000000000,0.000208333333333,612,2003,1391,1412.333333333333258,586.907336998117785,4237.000000000000000,3,612,1,33.3333015,612,1,33.3333015,1622,2003
2022,5.000000000000000,0.000347222222222,196,1217,1021,813.399999999999977,380.068730626448712,4067.000000000000000,5,196,1,20.0000000,196,1,20.0000000,923,1217
2023,4.000000000000000,0.000277777777778,446,591,145,499.500000000000000,57.569523187186462,1998.000000000000000,4,446,1,25.0000000,446,1,25.0000000,455,591
2024,4.000000000000000,0.000277777777778,468,3499,3031,1230.500000000000000,1309.732892615895253,4922.000000000000000,4,468,1,25.0000000,468,1,25.0000000,471,3499
2025,5.000000000000000,0.000347222222222,271,550,279,388.199999999999989,102.519071396496770,1941.000000000000000,5,271,1,20.0000000,271,1,20.0000000,417,550
2026,4.000000000000000,0.000277777777778,628,2266,1638,1145.250000000000000,664.574064721156560,4581.000000000000000,4,628,1,25.0000000,628,1,25.0000000,669,2266
2027,4.000000000000000,0.000277777777778,358,895,537,618.500000000000000,253.132870248018179,2474.000000000000000,4,358,1,25.0000000,358,1,25.0000000,374,895
2028,4.000000000000000,0.000277777777778,358,895,537,618.500000000000000,253.132870248018179,2474.000000000000000,4,358,1,25.0000000,358,1,25.0000000,374,895
2029,4.000000000000000,0.000277777777778,358,895,537,618.500000000000000,253.132870248018179,2474.000000000000000,4,358,1,25.0000000,358,1,25.0000000,374,895
2030,4.000000000000000,0.000277777777778,540,2213,1673,1397.750000000000000,599.637963691426080,5591.000000000000000,4,540,1,25.0000000,540,1,25.0000000,1283,2213
2031,5.000000000000000,0.000347222222222,413,1453,1040,1021.800000000000068,354.464892478789807,5109.000000000000000,5,413,1,20.0000000,413,1,20.0000000,1056,1453
2032,3.000000000000000,0.000208333333333,229,599,370,444.000000000000000,156.896993810164076,1332.000000000000000,3,229,1,33.3333015,229,1,33.3333015,504,599
2033,4.000000000000000,0.000277777777778,10,241,231,107.750000000000000,84.247774451317113,431.000000000000000,4,10,1,25.0000000,10,1,25.0000000,75,241
2034,4.000000000000000,0.000277777777778,1510,2810,1300,1902.750000000000000,526.766255088535445,7611.000000000000000,4,1510,1,25.0000000,1510,1,25.0000000,1635,2810
2035,4.000000000000000,0.000277777777778,234,790,556,405.500000000000000,224.575711064219945,1622.000000000000000,4,234,1,25.0000000,234,1,25.0000000,269,790
2036,3.000000000000000,0.000208333333333,349,478,129,427.000000000000000,56.017854296643669,1281.000000000000000,3,349,1,33.3333015,349,1,33.3333015,454,478
2037,4.000000000000000,0.000277777777778,76,394,318,232.500000000000000,121.487653693698434,930.000000000000000,4,76,1,25.0000000,76,1,25.0000000,165,394
2038,4.000000000000000,0.000277777777778,563,4655,4092,1849.250000000000000,1634.103175292184460,7397.000000000000000,4,563,1,25.0000000,563,1,25.0000000,1084,4655
2039,4.000000000000000,0.000277777777778,441,1729,1288,1033.000000000000000,459.865741276733957,4132.000000000000000,4,441,1,25.0000000,441,1,25.0000000,928,1729
2040,4.000000000000000,0.000277777777778,343,993,650,608.750000000000000,241.535064742161182,2435.000000000000000,4,343,1,25.0000000,343,1,25.0000000,486,993
2041,4.000000000000000,0.000277777777778,376,1610,1234,968.500000000000000,446.391364163779485,3874.000000000000000,4,376,1,25.0000000,376,1,25.0000000,815,1610
2042,4.000000000000000,0.000277777777778,222,854,632,611.500000000000000,235.330087324166868,2446.000000000000000,4,222,1,25.0000000,222,1,25.0000000,675,854
2043,4.000000000000000,0.000277777777778,413,1562,1149,1075.500000000000000,449.905823478647562,4302.000000000000000,4,413,1,25.0000000,413,1,25.0000000,920,1562
2044,4.000000000000000,0.000277777777778,503,936,433,682.250000000000000,162.455186128359742,2729.000000000000000,4,503,1,25.0000000,503,1,25.0000000,589,936
2045,4.000000000000000,0.000277777777778,0,461,461,231.000000000000000,171.509474956924748,924.000000000000000,4,0,1,25.0000000,0,1,25.0000000,156,461
2046,5.000000000000000,0.000347222222222,280,960,680,613.200000000000045,280.473456854654955,3066.000000000000000,5,280,1,20.0000000,280,1,20.0000000,569,960
2047,4.000000000000000,0.000277777777778,277,1045,768,642.500000000000000,334.900358315723508,2570.000000000000000,4,277,1,25.0000000,277,1,25.0000000,348,1045
2048,4.000000000000000,0.000277777777778,332,476,144,415.250000000000000,58.178067173119459,1661.000000000000000,4,332,1,25.0000000,332,1,25.0000000,390,476
2049,5.000000000000000,0.000347222222222,344,1317,973,855.399999999999977,376.871118553810106,4277.000000000000000,5,344,1,20.0000000,344,1,20.0000000,770,1317
2050,4.000000000000000,0.000277777777778,216,604,388,434.250000000000000,143.635606657959300,1737.000000000000000,4,216,1,25.0000000,216,1,25.0000000,409,604
2051,5.000000000000000,0.000347222222222,216,599,383,439.399999999999977,127.800782470218081,2197.000000000000000,5,216,1,20.0000000,216,1,20.0000000,465,599
2052,4.000000000000000,0.000277777777778,339,1996,1657,1257.000000000000000,609.854490841872916,5028.000000000000000,4,339,1,25.0000000,339,1,25.0000000,1143,1996
2053,3.000000000000000,0.000208333333333,689,945,256,855.000000000000000,117.518792823389177,2565.000000000000000,3,689,1,33.3333015,689,1,33.3333015,931,945
2054,4.000000000000000,0.000277777777778,899,1817,918,1383.750000000000000,352.077672538319291,5535.000000000000000,4,899,1,25.0000000,899,1,25.0000000,1220,1817
2055,4.000000000000000,0.000277777777778,899,1817,918,1383.750000000000000,352.077672538319291,5535.000000000000000,4,899,1,25.0000000,899,1,25.0000000,1220,1817
2056,4.000000000000000,0.000277777777778,4638,9550,4912,6608.500000000000000,2069.474873005226982,26434.000000000000000,4,4638,1,25.0000000,4638,1,25.0000000,4687,9550
2057,5.000000000000000,0.000347222222222,322,531,209,412.399999999999977,97.035251326515365,2062.000000000000000,3,339,2,40.0000000,322,1,20.0000000,339,531
2058,4.000000000000000,0.000277777777778,143,520,377,252.000000000000000,155.584382249633279,1008.000000000000000,4,143,1,25.0000000,143,1,25.0000000,157,520
2059,4.000000000000000,0.000277777777778,229,824,595,410.750000000000000,242.593667477121102,1643.000000000000000,4,229,1,25.0000000,229,1,25.0000000,246,824
2060,4.000000000000000,0.000277777777778,257,591,334,475.000000000000000,130.144150848203708,1900.000000000000000,4,257,1,25.0000000,257,1,25.0000000,498,591
2061,4.000000000000000,0.000277777777778,680,5281,4601,2268.500000000000000,1778.054906351319687,9074.000000000000000,4,680,1,25.0000000,680,1,25.0000000,1427,5281
2062,5.000000000000000,0.000347222222222,340,640,300,464.399999999999977,110.411231312760933,2322.000000000000000,5,340,1,20.0000000,340,1,20.0000000,404,640
2063,5.000000000000000,0.000347222222222,340,640,300,464.399999999999977,110.411231312760933,2322.000000000000000,5,340,1,20.0000000,340,1,20.0000000,404,640
2064,4.000000000000000,0.000277777777778,141,4161,4020,1407.500000000000000,1604.038730829153110,5630.000000000000000,4,141,1,25.0000000,141,1,25.0000000,650,4161
2065,4.000000000000000,0.000277777777778,65,1161,1096,653.750000000000000,504.622321642632073,2615.000000000000000,4,65,1,25.0000000,65,1,25.0000000,241,1161
2066,4.000000000000000,0.000277777777778,209,697,488,450.250000000000000,226.961863536586264,1801.000000000000000,4,209,1,25.0000000,209,1,25.0000000,239,697
2067,4.000000000000000,0.000277777777778,281,616,335,475.500000000000000,131.579823681292424,1902.000000000000000,4,281,1,25.0000000,281,1,25.0000000,431,616
2068,4.000000000000000,0.000277777777778,81,163,82,112.750000000000000,30.433328769623611,451.000000000000000,4,81,1,25.0000000,81,1,25.0000000,103,163
2069,4.000000000000000,0.000277777777778,60,439,379,240.750000000000000,142.160780456495814,963.000000000000000,4,60,1,25.0000000,60,1,25.0000000,166,439
2070,4.000000000000000,0.000277777777778,130,440,310,223.500000000000028,125.875930979675374,894.000000000000000,4,130,1,25.0000000,130,1,25.0000000,152,440
2071,4.000000000000000,0.000277777777778,397,2374,1977,1159.500000000000000,742.373389878705211,4638.000000000000000,4,397,1,25.0000000,397,1,25.0000000,782,2374
2072,5.000000000000000,0.000347222222222,1975,2864,889,2275.599999999999909,308.132828500956691,11378.000000000000000,5,1975,1,20.0000000,1975,1,20.0000000,2146,2864
2073,4.000000000000000,0.000277777777778,222,840,618,512.500000000000000,220.370710395006881,2050.000000000000000,4,222,1,25.0000000,222,1,25.0000000,463,840
2074,5.000000000000000,0.000347222222222,376,1610,1234,982.200000000000045,475.114470417393193,4911.000000000000000,5,376,1,20.0000000,376,1,20.0000000,905,1610
2075,4.000000000000000,0.000277777777778,595,1007,412,772.000000000000000,167.330511264383574,3088.000000000000000,4,595,1,25.0000000,595,1,25.0000000,634,1007
2076,4.000000000000000,0.000277777777778,354,1292,938,826.750000000000000,392.743793712898764,3307.000000000000000,4,354,1,25.0000000,354,1,25.0000000,533,1292
2077,4.000000000000000,0.000277777777778,572,787,215,675.750000000000000,89.275906604189686,2703.000000000000000,4,572,1,25.0000000,572,1,25.0000000,606,787
2078,4.000000000000000,0.000277777777778,102,509,407,394.750000000000000,169.327161140792754,1579.000000000000000,3,484,2,50.0000000,102,1,25.0000000,484,509
2079,4.000000000000000,0.000277777777778,329,779,450,553.750000000000000,191.409737213131365,2215.000000000000000,4,329,1,25.0000000,329,1,25.0000000,403,779
2080,4.000000000000000,0.000277777777778,141,650,509,370.250000000000000,228.112225669734755,1481.000000000000000,4,141,1,25.0000000,141,1,25.0000000,150,650
2081,4.000000000000000,0.000277777777778,457,1884,1427,1012.750000000000000,581.004894557696502,4051.000000000000000,4,457,1,25.0000000,457,1,25.0000000,514,1884
2082,4.000000000000000,0.000277777777778,400,697,297,556.750000000000000,108.702288384375791,2227.000000000000000,4,400,1,25.0000000,400,1,25.0000000,527,697
2083,4.000000000000000,0.000277777777778,0,1376,1376,517.500000000000000,539.913650503485655,2070.000000000000000,4,0,1,25.0000000,0,1,25.0000000,120,1376
2084,4.000000000000000,0.000277777777778,0,1376,1376,517.500000000000000,539.913650503485655,2070.000000000000000,4,0,1,25.0000000,0,1,25.0000000,120,1376
2085,4.000000000000000,0.000277777777778,563,1027,464,730.500000000000000,178.101796734339558,2922.000000000000000,4,563,1,25.0000000,563,1,25.0000000,630,1027
2086,4.000000000000000,0.000277777777778,56,251,195,127.750000000000000,77.872893229929502,511.000000000000000,4,56,1,25.0000000,56,1,25.0000000,66,251
2087,4.000000000000000,0.000277777777778,295,750,455,549.500000000000000,174.963567636236775,2198.000000000000000,4,295,1,25.0000000,295,1,25.0000000,487,750
2088,4.000000000000000,0.000277777777778,170,849,679,411.750000000000000,262.765461010384684,1647.000000000000000,4,170,1,25.0000000,170,1,25.0000000,253,849
2089,3.000000000000000,0.000208333333333,64,524,460,341.666666666666629,199.526662100304037,1025.000000000000000,3,64,1,33.3333015,64,1,33.3333015,437,524
2090,4.000000000000000,0.000277777777778,258,710,452,451.250000000000000,174.718881349440892,1805.000000000000000,4,258,1,25.0000000,258,1,25.0000000,330,710
2091,4.000000000000000,0.000277777777778,58,710,652,339.000000000000000,236.243518429606866,1356.000000000000000,4,58,1,25.0000000,58,1,25.0000000,258,710
2092,4.000000000000000,0.000277777777778,520,9550,9030,3773.750000000000000,3485.217667162267844,15095.000000000000000,4,520,1,25.0000000,520,1,25.0000000,1660,9550
2093,4.000000000000000,0.000277777777778,150,3007,2857,1023.500000000000114,1154.550670174332254,4094.000000000000000,4,150,1,25.0000000,150,1,25.0000000,372,3007
2094,4.000000000000000,0.000277777777778,39,1720,1681,775.500000000000000,670.467933610549380,3102.000000000000000,4,39,1,25.0000000,39,1,25.0000000,258,1720
2095,4.000000000000000,0.000277777777778,362,1049,687,654.250000000000000,293.708507707897354,2617.000000000000000,4,362,1,25.0000000,362,1,25.0000000,381,1049
2096,4.000000000000000,0.000277777777778,69,702,633,292.500000000000000,242.874967833245421,1170.000000000000000,4,69,1,25.0000000,69,1,25.0000000,177,702
2097,3.000000000000000,0.000208333333333,874,3167,2293,1659.333333333333258,1066.391527014768144,4978.000000000000000,3,874,1,33.3333015,874,1,33.3333015,937,3167
2098,4.000000000000000,0.000277777777778,53,614,561,290.750000000000000,213.729238757826494,1163.000000000000000,4,53,1,25.0000000,53,1,25.0000000,153,614
2099,4.000000000000000,0.000277777777778,53,614,561,290.750000000000000,213.729238757826494,1163.000000000000000,4,53,1,25.0000000,53,1,25.0000000,153,614
2100,4.000000000000000,0.000277777777778,0,794,794,396.250000000000000,396.251419555816881,1585.000000000000000,3,0,2,50.0000000,791,1,25.0000000,0,794
2101,4.000000000000000,0.000277777777778,148,691,543,357.500000000000000,202.425912372897557,1430.000000000000000,4,148,1,25.0000000,148,1,25.0000000,272,691
2102,4.000000000000000,0.000277777777778,20,602,582,405.500000000000000,228.369765949873482,1622.000000000000000,4,20,1,25.0000000,20,1,25.0000000,458,602
2103,4.000000000000000,0.000277777777778,245,660,415,422.250000000000000,175.029104722614619,1689.000000000000000,4,245,1,25.0000000,245,1,25.0000000,264,660
2104,3.000000000000000,0.000208333333333,201,253,52,231.666666666666657,22.231109334044088,695.000000000000000,3,201,1,33.3333015,201,1,33.3333015,241,253
2105,3.000000000000000,0.000208333333333,2360,9746,7386,4855.333333333333940,3458.464527632008412,14566.000000000000000,3,2360,1,33.3333015,2360,1,33.3333015,2460,9746
2106,4.000000000000000,0.000277777777778,457,763,306,604.500000000000000,128.977711252758695,2418.000000000000000,4,457,1,25.0000000,457,1,25.0000000,500,763
2107,4.000000000000000,0.000277777777778,2520,7920,5400,4923.750000000000000,2333.835938428406280,19695.000000000000000,4,2520,1,25.0000000,2520,1,25.0000000,2776,7920
2108,4.000000000000000,0.000277777777778,397,911,514,613.750000000000000,192.690652342037595,2455.000000000000000,4,397,1,25.0000000,397,1,25.0000000,503,911
2109,4.000000000000000,0.000277777777778,567,1326,759,1002.750000000000000,330.902081437998845,4011.000000000000000,4,567,1,25.0000000,567,1,25.0000000,797,1326
2110,5.000000000000000,0.000347222222222,99,2168,2069,1012.000000000000000,832.865175163423487,5060.000000000000000,5,99,1,20.0000000,99,1,20.0000000,490,2168
2111,4.000000000000000,0.000277777777778,71,1231,1160,698.000000000000000,414.030795956049644,2792.000000000000000,4,71,1,25.0000000,71,1,25.0000000,700,1231
2112,4.000000000000000,0.000277777777778,1175,7701,6526,3490.750000000000000,2563.181068028554364,13963.000000000000000,4,1175,1,25.0000000,1175,1,25.0000000,1708,7701
2113,4.000000000000000,0.000277777777778,311,1463,1152,893.250000000000000,444.752951086330597,3573.000000000000000,4,311,1,25.0000000,311,1,25.0000000,647,1463
2114,3.000000000000000,0.000208333333333,574,603,29,586.000000000000000,12.355835328567093,1758.000000000000000,3,574,1,33.3333015,574,1,33.3333015,581,603
2115,4.000000000000000,0.000277777777778,824,1888,1064,1261.750000000000000,453.145878829323578,5047.000000000000000,4,824,1,25.0000000,824,1,25.0000000,836,1888
2116,4.000000000000000,0.000277777777778,824,1888,1064,1261.750000000000000,453.145878829323578,5047.000000000000000,4,824,1,25.0000000,824,1,25.0000000,836,1888
2117,3.000000000000000,0.000208333333333,150,904,754,529.666666666666742,307.842311726131754,1589.000000000000000,3,150,1,33.3333015,150,1,33.3333015,535,904
2118,4.000000000000000,0.000277777777778,79,520,441,286.500000000000000,173.946112345174299,1146.000000000000000,4,79,1,25.0000000,79,1,25.0000000,166,520
2119,4.000000000000000,0.000277777777778,300,850,550,556.750000000000000,248.593418054460955,2227.000000000000000,4,300,1,25.0000000,300,1,25.0000000,321,850
2120,4.000000000000000,0.000277777777778,612,3280,2668,1532.750000000000000,1040.941250743768023,6131.000000000000000,4,612,1,25.0000000,612,1,25.0000000,905,3280
2121,4.000000000000000,0.000277777777778,143,222,79,175.000000000000000,29.094673051952306,700.000000000000000,4,143,1,25.0000000,143,1,25.0000000,163,222
2122,4.000000000000000,0.000277777777778,686,1229,543,913.000000000000000,207.640314004771227,3652.000000000000000,4,686,1,25.0000000,686,1,25.0000000,776,1229
2123,4.000000000000000,0.000277777777778,82,1006,924,479.250000000000000,362.515775518804162,1917.000000000000000,4,82,1,25.0000000,82,1,25.0000000,212,1006
2124,5.000000000000000,0.000347222222222,253,1972,1719,817.399999999999977,612.187095584348299,4087.000000000000000,5,253,1,20.0000000,253,1,20.0000000,672,1972
2125,4.000000000000000,0.000277777777778,234,4640,4406,1527.750000000000000,1806.096948532940814,6111.000000000000000,4,234,1,25.0000000,234,1,25.0000000,487,4640
2126,4.000000000000000,0.000277777777778,107,595,488,329.750000000000000,218.198733955997085,1319.000000000000000,4,107,1,25.0000000,107,1,25.0000000,122,595
2127,4.000000000000000,0.000277777777778,107,595,488,329.750000000000000,218.198733955997085,1319.000000000000000,4,107,1,25.0000000,107,1,25.0000000,122,595
2128,4.000000000000000,0.000277777777778,107,595,488,329.750000000000000,218.198733955997085,1319.000000000000000,4,107,1,25.0000000,107,1,25.0000000,122,595
2129,4.000000000000000,0.000277777777778,149,735,586,477.000000000000000,225.818511198705750,1908.000000000000000,4,149,1,25.0000000,149,1,25.0000000,395,735
2130,4.000000000000000,0.000277777777778,371,1124,753,719.000000000000000,275.124517264456074,2876.000000000000000,4,371,1,25.0000000,371,1,25.0000000,601,1124
2131,4.000000000000000,0.000277777777778,25,636,611,445.500000000000000,244.859653679408780,1782.000000000000000,4,25,1,25.0000000,25,1,25.0000000,549,636
2132,4.000000000000000,0.000277777777778,1022,1437,415,1156.750000000000000,168.162681650834799,4627.000000000000000,4,1022,1,25.0000000,1022,1,25.0000000,1030,1437
2133,4.000000000000000,0.000277777777778,2,1265,1263,466.750000000000000,483.662782835313863,1867.000000000000000,4,2,1,25.0000000,2,1,25.0000000,184,1265
2134,3.000000000000000,0.000208333333333,2,416,414,200.666666666666657,169.425171945873757,602.000000000000000,3,2,1,33.3333015,2,1,33.3333015,184,416
2135,2.000000000000000,0.000138888888889,263,264,1,263.500000000000000,0.500000000000000,527.000000000000000,2,263,1,50.0000000,263,1,50.0000000,263,264
2136,4.000000000000000,0.000277777777778,143,1347,1204,773.000000000000000,573.942941414911047,3092.000000000000000,4,143,1,25.0000000,143,1,25.0000000,258,1347
2137,4.000000000000000,0.000277777777778,291,1131,840,800.000000000000000,354.122860035892131,3200.000000000000000,3,1131,2,50.0000000,291,1,25.0000000,647,1131
2138,4.000000000000000,0.000277777777778,694,1499,805,1093.250000000000000,341.162259782643616,4373.000000000000000,4,694,1,25.0000000,694,1,25.0000000,824,1499
2139,5.000000000000000,0.000347222222222,98,1555,1457,522.000000000000000,544.042277768924919,2610.000000000000000,5,98,1,20.0000000,98,1,20.0000000,214,1555
2140,4.000000000000000,0.000277777777778,548,1790,1242,989.500000000000000,474.384601352109712,3958.000000000000000,3,810,2,50.0000000,548,1,25.0000000,810,1790
2141,4.000000000000000,0.000277777777778,515,4312,3797,1643.750000000000000,1566.143891058545023,6575.000000000000000,4,515,1,25.0000000,515,1,25.0000000,533,4312
2142,3.000000000000000,0.000208333333333,143,188,45,162.666666666666657,18.803073034893941,488.000000000000000,3,143,1,33.3333015,143,1,33.3333015,157,188
2143,3.000000000000000,0.000208333333333,73,704,631,316.666666666666686,276.911939472140205,950.000000000000000,3,73,1,33.3333015,73,1,33.3333015,173,704
2144,4.000000000000000,0.000277777777778,823,3499,2676,1644.750000000000000,1078.727114473349957,6579.000000000000000,4,823,1,25.0000000,823,1,25.0000000,1065,3499
2145,4.000000000000000,0.000277777777778,234,2251,2017,970.499999999999886,765.967525421280470,3882.000000000000000,4,234,1,25.0000000,234,1,25.0000000,607,2251
2146,4.000000000000000,0.000277777777778,234,607,373,359.750000000000000,146.736796680314654,1439.000000000000000,4,234,1,25.0000000,234,1,25.0000000,269,607
2147,4.000000000000000,0.000277777777778,0,0,0,0.000000000000000,0.000000000000000,0.000000000000000,1,0,4,100.0000000,0,4,100.0000000,0,0
2148,4.000000000000000,0.000277777777778,149,735,586,477.000000000000000,225.818511198705750,1908.000000000000000,4,149,1,25.0000000,149,1,25.0000000,395,735
2149,4.000000000000000,0.000277777777778,149,735,586,477.000000000000000,225.818511198705750,1908.000000000000000,4,149,1,25.0000000,149,1,25.0000000,395,735
2150,4.000000000000000,0.000277777777778,0,928,928,293.750000000000000,379.814675203578702,1175.000000000000000,3,0,2,50.0000000,247,1,25.0000000,0,928
2151,3.000000000000000,0.000208333333333,1317,2178,861,1799.333333333333258,359.063906413452969,5398.000000000000000,3,1317,1,33.3333015,1317,1,33.3333015,1903,2178
2152,4.000000000000000,0.000277777777778,149,742,593,554.250000000000000,241.608541860589014,2217.000000000000000,4,149,1,25.0000000,149,1,25.0000000,591,742
2153,4.000000000000000,0.000277777777778,347,1604,1257,888.250000000000000,485.665201038740292,3553.000000000000000,4,347,1,25.0000000,347,1,25.0000000,553,1604
2154,4.000000000000000,0.000277777777778,196,465,269,334.250000000000000,107.608956411629606,1337.000000000000000,4,196,1,25.0000000,196,1,25.0000000,267,465
2155,4.000000000000000,0.000277777777778,41,704,663,247.750000000000000,267.878120607114909,991.000000000000000,4,41,1,25.0000000,41,1,25.0000000,73,704
2156,3.000000000000000,0.000208333333333,413,662,249,518.666666666666629,105.085150658353683,1556.000000000000000,3,413,1,33.3333015,413,1,33.3333015,481,662
2157,4.000000000000000,0.000277777777778,517,858,341,648.000000000000000,128.932152700557992,2592.000000000000000,4,517,1,25.0000000,517,1,25.0000000,576,858
2158,4.000000000000000,0.000277777777778,517,858,341,648.000000000000000,128.932152700557992,2592.000000000000000,4,517,1,25.0000000,517,1,25.0000000,576,858
2159,3.000000000000000,0.000208333333333,368,389,21,377.000000000000000,8.831760866327848,1131.000000000000000,3,368,1,33.3333015,368,1,33.3333015,374,389
2160,4.000000000000000,0.000277777777778,307,758,451,550.500000000000000,179.416415079557311,2202.000000000000000,4,307,1,25.0000000,307,1,25.0000000,455,758
2161,4.000000000000000,0.000277777777778,64,858,794,305.000000000000000,321.167401832751409,1220.000000000000000,4,64,1,25.0000000,64,1,25.0000000,145,858
2162,4.000000000000000,0.000277777777778,701,2576,1875,1659.250000000000000,679.967416498761395,6637.000000000000000,4,701,1,25.0000000,701,1,25.0000000,1468,2576
2163,4.000000000000000,0.000277777777778,612,3125,2513,1413.250000000000000,999.584507432963392,5653.000000000000000,4,612,1,25.0000000,612,1,25.0000000,887,3125
2164,4.000000000000000,0.000277777777778,282,795,513,500.250000000000000,218.274339994420785,2001.000000000000000,4,282,1,25.0000000,282,1,25.0000000,299,795
2165,4.000000000000000,0.000277777777778,164,400,236,295.250000000000000,84.697623933614565,1181.000000000000000,4,164,1,25.0000000,164,1,25.0000000,300,400
2166,4.000000000000000,0.000277777777778,430,632,202,524.000000000000000,75.458597919653926,2096.000000000000000,4,430,1,25.0000000,430,1,25.0000000,484,632
2167,4.000000000000000,0.000277777777778,393,717,324,535.750000000000000,140.785963433859422,2143.000000000000000,4,393,1,25.0000000,393,1,25.0000000,404,717
2168,4.000000000000000,0.000277777777778,378,874,496,654.000000000000000,192.753728887406993,2616.000000000000000,4,378,1,25.0000000,378,1,25.0000000,576,874
2169,4.000000000000000,0.000277777777778,196,465,269,334.250000000000000,107.608956411629606,1337.000000000000000,4,196,1,25.0000000,196,1,25.0000000,267,465
2170,4.000000000000000,0.000277777777778,196,465,269,334.250000000000000,107.608956411629606,1337.000000000000000,4,196,1,25.0000000,196,1,25.0000000,267,465
2171,4.000000000000000,0.000277777777778,196,465,269,334.250000000000000,107.608956411629606,1337.000000000000000,4,196,1,25.0000000,196,1,25.0000000,267,465
2172,4.000000000000000,0.000277777777778,41,724,683,416.250000000000000,302.833597046298678,1665.000000000000000,4,41,1,25.0000000,41,1,25.0000000,196,724
2173,5.000000000000000,0.000347222222222,41,724,683,257.000000000000000,239.544567878296903,1285.000000000000000,5,41,1,20.0000000,41,1,20.0000000,176,724
2174,3.000000000000000,0.000208333333333,796,3131,2335,1650.000000000000000,1051.317586016074756,4950.000000000000000,3,796,1,33.3333015,796,1,33.3333015,1023,3131
2175,4.000000000000000,0.000277777777778,498,984,486,749.750000000000000,179.933842008667170,2999.000000000000000,4,498,1,25.0000000,498,1,25.0000000,684,984
2176,4.000000000000000,0.000277777777778,713,858,145,819.000000000000000,61.363670033660796,3276.000000000000000,3,858,2,50.0000000,713,1,25.0000000,847,858
2177,5.000000000000000,0.000347222222222,3,1162,1159,605.000000000000000,385.670844114511738,3025.000000000000000,5,3,1,20.0000000,3,1,20.0000000,561,1162
2178,4.000000000000000,0.000277777777778,76,345,269,226.250000000000000,106.797413358189530,905.000000000000000,4,76,1,25.0000000,76,1,25.0000000,177,345
2179,4.000000000000000,0.000277777777778,92,751,659,383.750000000000000,266.500820824251889,1535.000000000000000,4,92,1,25.0000000,92,1,25.0000000,171,751
2180,3.000000000000000,0.000208333333333,485,1323,838,888.666666666666629,342.798612728944534,2666.000000000000000,3,485,1,33.3333015,485,1,33.3333015,858,1323
2181,4.000000000000000,0.000277777777778,0,498,498,254.250000000000000,211.088103643952422,1017.000000000000000,4,0,1,25.0000000,0,1,25.0000000,95,498
2182,4.000000000000000,0.000277777777778,113,353,240,267.750000000000000,91.775200898717728,1071.000000000000000,4,113,1,25.0000000,113,1,25.0000000,297,353
2183,4.000000000000000,0.000277777777778,113,353,240,267.750000000000000,91.775200898717728,1071.000000000000000,4,113,1,25.0000000,113,1,25.0000000,297,353
2184,4.000000000000000,0.000277777777778,0,424,424,130.250000000000000,172.905140178075669,521.000000000000000,4,0,1,25.0000000,0,1,25.0000000,10,424
2185,4.000000000000000,0.000277777777778,193,2422,2229,844.750000000000000,913.906279385364542,3379.000000000000000,4,193,1,25.0000000,193,1,25.0000000,374,2422
2186,4.000000000000000,0.000277777777778,28,1225,1197,597.500000000000000,503.847447150424671,2390.000000000000000,4,28,1,25.0000000,28,1,25.0000000,184,1225
2187,4.000000000000000,0.000277777777778,2,875,873,522.500000000000000,320.807185081631246,2090.000000000000000,4,2,1,25.0000000,2,1,25.0000000,572,875
2188,4.000000000000000,0.000277777777778,365,546,181,489.750000000000000,72.860740457395849,1959.000000000000000,4,365,1,25.0000000,365,1,25.0000000,515,546
2189,4.000000000000000,0.000277777777778,216,716,500,446.000000000000000,192.775776486570038,1784.000000000000000,4,216,1,25.0000000,216,1,25.0000000,321,716
2190,4.000000000000000,0.000277777777778,393,1691,1298,835.000000000000000,505.404788263823264,3340.000000000000000,4,393,1,25.0000000,393,1,25.0000000,565,1691
2191,4.000000000000000,0.000277777777778,0,509,509,168.000000000000000,207.818430366510086,672.000000000000000,3,0,2,50.0000000,163,1,25.0000000,0,509
2192,5.000000000000000,0.000347222222222,0,153,153,89.799999999999997,56.176151523578042,449.000000000000000,5,0,1,20.0000000,0,1,20.0000000,87,153
2193,5.000000000000000,0.000347222222222,0,153,153,89.799999999999997,56.176151523578042,449.000000000000000,5,0,1,20.0000000,0,1,20.0000000,87,153
2194,5.000000000000000,0.000347222222222,0,153,153,89.799999999999997,56.176151523578042,449.000000000000000,5,0,1,20.0000000,0,1,20.0000000,87,153
2195,4.000000000000000,0.000277777777778,0,740,740,323.250000000000000,321.763402984242418,1293.000000000000000,4,0,1,25.0000000,0,1,25.0000000,20,740
2196,4.000000000000000,0.000277777777778,430,1509,1079,1114.500000000000000,417.951253138449147,4458.000000000000000,4,430,1,25.0000000,430,1,25.0000000,1132,1509
2197,4.000000000000000,0.000277777777778,534,1138,604,942.000000000000000,239.061707515026342,3768.000000000000000,4,534,1,25.0000000,534,1,25.0000000,1023,1138
2198,3.000000000000000,0.000208333333333,534,1073,539,876.666666666666629,243.160212388640787,2630.000000000000000,3,534,1,33.3333015,534,1,33.3333015,1023,1073
2199,4.000000000000000,0.000277777777778,534,1138,604,942.000000000000000,239.061707515026342,3768.000000000000000,4,534,1,25.0000000,534,1,25.0000000,1023,1138
2200,4.000000000000000,0.000277777777778,0,732,732,320.000000000000000,312.497199987455872,1280.000000000000000,4,0,1,25.0000000,0,1,25.0000000,35,732
2201,5.000000000000000,0.000347222222222,285,4171,3886,1273.000000000000000,1463.571931952782279,6365.000000000000000,5,285,1,20.0000000,285,1,20.0000000,740,4171
2202,4.000000000000000,0.000277777777778,282,1107,825,580.000000000000000,334.489910161726698,2320.000000000000000,4,282,1,25.0000000,282,1,25.0000000,300,1107
2203,4.000000000000000,0.000277777777778,406,2451,2045,1078.750000000000000,803.220198637957537,4315.000000000000000,4,406,1,25.0000000,406,1,25.0000000,716,2451
2204,4.000000000000000,0.000277777777778,358,895,537,618.500000000000000,253.132870248018179,2474.000000000000000,4,358,1,25.0000000,358,1,25.0000000,374,895
2205,4.000000000000000,0.000277777777778,817,1229,412,1031.000000000000000,183.320757144410692,4124.000000000000000,4,817,1,25.0000000,817,1,25.0000000,882,1229
2206,4.000000000000000,0.000277777777778,35,522,487,203.750000000000000,196.457851713796373,815.000000000000000,4,35,1,25.0000000,35,1,25.0000000,47,522
2207,4.000000000000000,0.000277777777778,73,2024,1951,1026.500000000000000,855.300678124365845,4106.000000000000000,4,73,1,25.0000000,73,1,25.0000000,290,2024
2208,4.000000000000000,0.000277777777778,218,850,632,499.000000000000000,226.916284122581203,1996.000000000000000,4,218,1,25.0000000,218,1,25.0000000,438,850
2209,5.000000000000000,0.000347222222222,462,3614,3152,1985.599999999999909,1007.758423432917766,9928.000000000000000,5,462,1,20.0000000,462,1,20.0000000,2076,3614
2210,5.000000000000000,0.000347222222222,0,437,437,145.599999999999994,184.202714420824975,728.000000000000000,3,0,3,60.0000000,291,1,20.0000000,0,437
2211,4.000000000000000,0.000277777777778,713,3655,2942,1982.250000000000000,1067.030780952452233,7929.000000000000000,4,713,1,25.0000000,713,1,25.0000000,1602,3655
2212,4.000000000000000,0.000277777777778,173,446,273,249.000000000000000,114.439940580201281,996.000000000000000,3,173,2,50.0000000,204,1,25.0000000,173,446
2213,4.000000000000000,0.000277777777778,796,2502,1706,1682.000000000000000,607.787791914250306,6728.000000000000000,4,796,1,25.0000000,796,1,25.0000000,1620,2502
2214,4.000000000000000,0.000277777777778,384,1226,842,685.750000000000000,331.634116911996898,2743.000000000000000,4,384,1,25.0000000,384,1,25.0000000,447,1226
2215,4.000000000000000,0.000277777777778,28,74,46,49.500000000000000,16.469669092000604,198.000000000000000,4,28,1,25.0000000,28,1,25.0000000,45,74
2216,4.000000000000000,0.000277777777778,1129,5376,4247,3032.000000000000000,1647.733139801466677,12128.000000000000000,4,1129,1,25.0000000,1129,1,25.0000000,1904,5376
2217,4.000000000000000,0.000277777777778,28,657,629,241.250000000000000,251.465082069061822,965.000000000000000,4,28,1,25.0000000,28,1,25.0000000,56,657
2218,4.000000000000000,0.000277777777778,709,2484,1775,1308.250000000000000,705.786219403581185,5233.000000000000000,4,709,1,25.0000000,709,1,25.0000000,814,2484
2219,4.000000000000000,0.000277777777778,0,1038,1038,371.000000000000000,395.831403504067680,1484.000000000000000,4,0,1,25.0000000,0,1,25.0000000,209,1038
2220,4.000000000000000,0.000277777777778,28,2283,2255,1196.750000000000000,822.855812095898159,4787.000000000000000,4,28,1,25.0000000,28,1,25.0000000,956,2283
2221,4.000000000000000,0.000277777777778,767,2474,1707,1586.750000000000000,651.830259730245984,6347.000000000000000,4,767,1,25.0000000,767,1,25.0000000,1208,2474
2222,4.000000000000000,0.000277777777778,767,2561,1794,1752.500000000000000,781.332995591508393,7010.000000000000000,4,767,1,25.0000000,767,1,25.0000000,1208,2561
2223,3.000000000000000,0.000208333333333,767,2474,1707,1713.000000000000000,709.051479090199791,5139.000000000000000,3,767,1,33.3333015,767,1,33.3333015,1898,2474
2224,4.000000000000000,0.000277777777778,269,1043,774,659.750000000000000,287.056941215501695,2639.000000000000000,4,269,1,25.0000000,269,1,25.0000000,541,1043
2225,4.000000000000000,0.000277777777778,688,3672,2984,1497.250000000000000,1256.980384691821655,5989.000000000000000,4,688,1,25.0000000,688,1,25.0000000,774,3672
2226,4.000000000000000,0.000277777777778,941,5622,4681,2427.000000000000000,1889.250777424744228,9708.000000000000000,4,941,1,25.0000000,941,1,25.0000000,1125,5622
2227,4.000000000000000,0.000277777777778,361,658,297,487.250000000000000,107.729696462953058,1949.000000000000000,4,361,1,25.0000000,361,1,25.0000000,452,658
2228,4.000000000000000,0.000277777777778,376,2166,1790,1278.000000000000000,670.248834389139347,5112.000000000000000,4,376,1,25.0000000,376,1,25.0000000,973,2166
2229,5.000000000000000,0.000347222222222,213,1161,948,531.000000000000000,396.254463697256028,2655.000000000000000,4,221,2,40.0000000,213,1,20.0000000,221,1161
2230,4.000000000000000,0.000277777777778,392,699,307,513.500000000000000,113.204461042840535,2054.000000000000000,4,392,1,25.0000000,392,1,25.0000000,477,699
2231,5.000000000000000,0.000347222222222,29,989,960,486.600000000000023,392.402140666943865,2433.000000000000000,5,29,1,20.0000000,29,1,20.0000000,420,989
2232,4.000000000000000,0.000277777777778,147,2299,2152,1024.000000000000000,840.647964370342152,4096.000000000000000,4,147,1,25.0000000,147,1,25.0000000,405,2299
2233,4.000000000000000,0.000277777777778,44,451,407,286.000000000000000,160.759136598826018,1144.000000000000000,4,44,1,25.0000000,44,1,25.0000000,239,451
2234,4.000000000000000,0.000277777777778,5,1175,1170,539.250000000000000,531.067968813785683,2157.000000000000000,4,5,1,25.0000000,5,1,25.0000000,23,1175
2235,4.000000000000000,0.000277777777778,2,137,135,61.250000000000000,55.737666797238653,245.000000000000000,4,2,1,25.0000000,2,1,25.0000000,14,137
2236,4.000000000000000,0.000277777777778,542,5985,5443,2081.750000000000000,2260.005904306446610,8327.000000000000000,4,542,1,25.0000000,542,1,25.0000000,775,5985
2237,4.000000000000000,0.000277777777778,0,0,0,0.000000000000000,0.000000000000000,0.000000000000000,1,0,4,100.0000000,0,4,100.0000000,0,0
2238,4.000000000000000,0.000277777777778,739,1367,628,1032.750000000000000,227.857822994954489,4131.000000000000000,4,739,1,25.0000000,739,1,25.0000000,946,1367
2239,4.000000000000000,0.000277777777778,3,536,533,250.750000000000000,240.214877765720416,1003.000000000000000,4,3,1,25.0000000,3,1,25.0000000,23,536
2240,4.000000000000000,0.000277777777778,221,722,501,408.000000000000000,197.859798847567845,1632.000000000000000,4,221,1,25.0000000,221,1,25.0000000,258,722
2241,4.000000000000000,0.000277777777778,613,1808,1195,947.500000000000000,497.712015125212758,3790.000000000000000,4,613,1,25.0000000,613,1,25.0000000,675,1808
2242,4.000000000000000,0.000277777777778,185,1349,1164,736.000000000000000,415.830494312285850,2944.000000000000000,4,185,1,25.0000000,185,1,25.0000000,633,1349
2243,3.000000000000000,0.000208333333333,185,777,592,531.666666666666742,252.081115692724779,1595.000000000000000,3,185,1,33.3333015,185,1,33.3333015,633,777
2244,2.000000000000000,0.000138888888889,121,395,274,258.000000000000000,137.000000000000000,516.000000000000000,2,121,1,50.0000000,121,1,50.0000000,121,395
2245,4.000000000000000,0.000277777777778,122,2230,2108,1203.500000000000000,924.232789939850591,4814.000000000000000,4,122,1,25.0000000,122,1,25.0000000,459,2230
2246,4.000000000000000,0.000277777777778,28,707,679,206.750000000000028,288.944090612699654,827.000000000000000,4,28,1,25.0000000,28,1,25.0000000,40,707
2247,4.000000000000000,0.000277777777778,536,4150,3614,1809.750000000000000,1429.945868730701477,7239.000000000000000,4,536,1,25.0000000,536,1,25.0000000,771,4150
2248,4.000000000000000,0.000277777777778,862,4792,3930,2054.750000000000000,1609.291051208574800,8219.000000000000000,4,862,1,25.0000000,862,1,25.0000000,928,4792
2249,4.000000000000000,0.000277777777778,327,995,668,563.000000000000000,256.129849880875838,2252.000000000000000,4,327,1,25.0000000,327,1,25.0000000,444,995
2250,4.000000000000000,0.000277777777778,3,1639,1636,602.000000000000000,665.377712280776677,2408.000000000000000,4,3,1,25.0000000,3,1,25.0000000,36,1639
2251,4.000000000000000,0.000277777777778,294,1308,1014,891.000000000000000,435.991972403162492,3564.000000000000000,3,1308,2,50.0000000,294,1,25.0000000,654,1308
2252,5.000000000000000,0.000347222222222,390,3142,2752,1541.599999999999909,1044.007394609827543,7708.000000000000000,5,390,1,20.0000000,390,1,20.0000000,1845,3142
2253,4.000000000000000,0.000277777777778,36,1257,1221,488.250000000000000,471.856108893378632,1953.000000000000000,4,36,1,25.0000000,36,1,25.0000000,180,1257
2254,4.000000000000000,0.000277777777778,9,1745,1736,517.750000000000000,712.298173169073948,2071.000000000000000,4,9,1,25.0000000,9,1,25.0000000,102,1745
2255,4.000000000000000,0.000277777777778,0,814,814,276.250000000000000,332.423205417431689,1105.000000000000000,3,0,2,50.0000000,291,1,25.0000000,0,814
2256,4.000000000000000,0.000277777777778,518,2151,1633,1297.000000000000000,580.836035383480635,5188.000000000000000,4,518,1,25.0000000,518,1,25.0000000,1187,2151
2257,4.000000000000000,0.000277777777778,536,4150,3614,1614.000000000000000,1472.218563936754663,6456.000000000000000,4,536,1,25.0000000,536,1,25.0000000,803,4150
2258,5.000000000000000,0.000347222222222,9,3799,3790,1300.599999999999909,1299.510923386179229,6503.000000000000000,5,9,1,20.0000000,9,1,20.0000000,815,3799
2259,5.000000000000000,0.000347222222222,0,49581,49581,10599.399999999999636,19535.650566080465069,52997.000000000000000,3,0,3,60.0000000,3416,1,20.0000000,0,49581
2260,4.000000000000000,0.000277777777778,386,633,247,494.750000000000000,104.710016235315337,1979.000000000000000,4,386,1,25.0000000,386,1,25.0000000,401,633
2261,4.000000000000000,0.000277777777778,386,633,247,494.750000000000000,104.710016235315337,1979.000000000000000,4,386,1,25.0000000,386,1,25.0000000,401,633
2262,5.000000000000000,0.000347222222222,207,1621,1414,813.200000000000045,613.775985193295014,4066.000000000000000,5,207,1,20.0000000,207,1,20.0000000,528,1621
2263,5.000000000000000,0.000347222222222,311,930,619,639.600000000000023,198.070290553631509,3198.000000000000000,5,311,1,20.0000000,311,1,20.0000000,675,930
2264,4.000000000000000,0.000277777777778,311,677,366,567.000000000000000,150.618723935638229,2268.000000000000000,4,311,1,25.0000000,311,1,25.0000000,605,677
2265,3.000000000000000,0.000208333333333,572,848,276,730.666666666666629,116.405421790491445,2192.000000000000000,3,572,1,33.3333015,572,1,33.3333015,772,848
2266,4.000000000000000,0.000277777777778,951,2289,1338,1601.250000000000000,631.718440050628828,6405.000000000000000,4,951,1,25.0000000,951,1,25.0000000,991,2289
2267,4.000000000000000,0.000277777777778,746,1987,1241,1173.000000000000000,479.544054284900938,4692.000000000000000,4,746,1,25.0000000,746,1,25.0000000,975,1987
2268,5.000000000000000,0.000347222222222,406,985,579,642.399999999999977,267.298035907486565,3212.000000000000000,5,406,1,20.0000000,406,1,20.0000000,452,985
2269,4.000000000000000,0.000277777777778,63,2111,2048,866.000000000000000,789.942719442365615,3464.000000000000000,4,63,1,25.0000000,63,1,25.0000000,326,2111
2270,4.000000000000000,0.000277777777778,1003,1347,344,1213.750000000000000,129.956483101075037,4855.000000000000000,4,1003,1,25.0000000,1003,1,25.0000000,1218,1347
2271,4.000000000000000,0.000277777777778,102,1614,1512,921.750000000000000,628.810136289166394,3687.000000000000000,4,102,1,25.0000000,102,1,25.0000000,526,1614
2272,4.000000000000000,0.000277777777778,500,3825,3325,1434.750000000000000,1382.596719039937625,5739.000000000000000,4,500,1,25.0000000,500,1,25.0000000,706,3825
2273,4.000000000000000,0.000277777777778,592,3827,3235,2070.750000000000000,1168.899134870070839,8283.000000000000000,4,592,1,25.0000000,592,1,25.0000000,1653,3827
2274,4.000000000000000,0.000277777777778,9,1745,1736,601.750000000000000,691.140135934819000,2407.000000000000000,4,9,1,25.0000000,9,1,25.0000000,102,1745
2275,4.000000000000000,0.000277777777778,4,551,547,274.500000000000000,265.637440885128228,1098.000000000000000,4,4,1,25.0000000,4,1,25.0000000,14,551
2276,5.000000000000000,0.000347222222222,283,2932,2649,1431.799999999999955,1079.036125437883584,7159.000000000000000,5,283,1,20.0000000,283,1,20.0000000,944,2932
2277,4.000000000000000,0.000277777777778,862,2410,1548,1522.500000000000000,633.943806657971891,6090.000000000000000,4,862,1,25.0000000,862,1,25.0000000,986,2410
2278,4.000000000000000,0.000277777777778,123,343,220,218.500000000000000,90.800605724851863,874.000000000000000,4,123,1,25.0000000,123,1,25.0000000,141,343
2279,4.000000000000000,0.000277777777778,141,343,202,252.750000000000000,72.264704386027901,1011.000000000000000,4,141,1,25.0000000,141,1,25.0000000,260,343
2280,4.000000000000000,0.000277777777778,663,828,165,736.750000000000000,60.499483468869386,2947.000000000000000,4,663,1,25.0000000,663,1,25.0000000,709,828
2281,4.000000000000000,0.000277777777778,82,704,622,322.250000000000000,259.282061662583999,1289.000000000000000,4,82,1,25.0000000,82,1,25.0000000,85,704
2282,4.000000000000000,0.000277777777778,21,2320,2299,964.250000000000000,857.448941628596344,3857.000000000000000,4,21,1,25.0000000,21,1,25.0000000,505,2320
2283,4.000000000000000,0.000277777777778,635,863,228,732.500000000000000,85.151335867383793,2930.000000000000000,4,635,1,25.0000000,635,1,25.0000000,685,863
2284,4.000000000000000,0.000277777777778,21,2320,2299,964.250000000000000,857.448941628596344,3857.000000000000000,4,21,1,25.0000000,21,1,25.0000000,505,2320
2285,4.000000000000000,0.000277777777778,95,1087,992,758.000000000000000,394.220116178766318,3032.000000000000000,4,95,1,25.0000000,95,1,25.0000000,830,1087
2286,4.000000000000000,0.000277777777778,95,1087,992,758.000000000000000,394.220116178766318,3032.000000000000000,4,95,1,25.0000000,95,1,25.0000000,830,1087
2287,5.000000000000000,0.000347222222222,788,4900,4112,2143.800000000000182,1698.621841376119846,10719.000000000000000,4,788,2,40.0000000,866,1,20.0000000,866,4900
2288,5.000000000000000,0.000347222222222,192,1208,1016,694.000000000000000,333.943108927254286,3470.000000000000000,5,192,1,20.0000000,192,1,20.0000000,664,1208
2289,4.000000000000000,0.000277777777778,615,967,352,822.000000000000000,143.174718438696431,3288.000000000000000,4,615,1,25.0000000,615,1,25.0000000,763,967
2290,4.000000000000000,0.000277777777778,5,2745,2740,745.000000000000000,1155.937065760934956,2980.000000000000000,4,5,1,25.0000000,5,1,25.0000000,74,2745
2291,3.000000000000000,0.000208333333333,198,1205,1007,847.333333333333371,459.937918516063291,2542.000000000000000,3,198,1,33.3333015,198,1,33.3333015,1139,1205
2292,4.000000000000000,0.000277777777778,303,922,619,616.750000000000000,299.938639558160276,2467.000000000000000,4,303,1,25.0000000,303,1,25.0000000,331,922
2293,4.000000000000000,0.000277777777778,6,327,321,151.250000000000000,145.523838253394075,605.000000000000000,4,6,1,25.0000000,6,1,25.0000000,9,327
2294,4.000000000000000,0.000277777777778,19,2249,2230,591.500000000000000,957.062563263238303,2366.000000000000000,4,19,1,25.0000000,19,1,25.0000000,39,2249
2295,4.000000000000000,0.000277777777778,189,991,802,647.250000000000000,297.538547922785938,2589.000000000000000,4,189,1,25.0000000,189,1,25.0000000,606,991
2296,4.000000000000000,0.000277777777778,431,2864,2433,1536.250000000000000,887.369814395328603,6145.000000000000000,4,431,1,25.0000000,431,1,25.0000000,1160,2864
2297,4.000000000000000,0.000277777777778,111,1596,1485,510.250000000000000,627.944414339358559,2041.000000000000000,4,111,1,25.0000000,111,1,25.0000000,126,1596
2298,4.000000000000000,0.000277777777778,278,2219,1941,953.250000000000000,787.662483237585661,3813.000000000000000,4,278,1,25.0000000,278,1,25.0000000,305,2219
2299,4.000000000000000,0.000277777777778,962,3416,2454,1616.250000000000000,1039.701008703944581,6465.000000000000000,4,962,1,25.0000000,962,1,25.0000000,1025,3416
2300,4.000000000000000,0.000277777777778,85,966,881,605.250000000000000,370.027955025022379,2421.000000000000000,4,85,1,25.0000000,85,1,25.0000000,426,966
2301,3.000000000000000,0.000208333333333,396,1041,645,707.333333333333258,263.793269225901440,2122.000000000000000,3,396,1,33.3333015,396,1,33.3333015,685,1041
2302,4.000000000000000,0.000277777777778,427,1301,874,882.000000000000000,320.763152497290434,3528.000000000000000,4,427,1,25.0000000,427,1,25.0000000,781,1301
2303,4.000000000000000,0.000277777777778,40,1301,1261,696.750000000000000,493.216167111338677,2787.000000000000000,4,40,1,25.0000000,40,1,25.0000000,427,1301
2304,3.000000000000000,0.000208333333333,670,1906,1236,1245.666666666666515,508.134059301501907,3737.000000000000000,3,670,1,33.3333015,670,1,33.3333015,1161,1906
2305,3.000000000000000,0.000208333333333,603,1906,1303,1223.333333333333485,533.770445874337383,3670.000000000000000,3,603,1,33.3333015,603,1,33.3333015,1161,1906
2306,5.000000000000000,0.000347222222222,352,1056,704,795.000000000000000,262.291440958335500,3975.000000000000000,5,352,1,20.0000000,352,1,20.0000000,898,1056
2307,4.000000000000000,0.000277777777778,295,2414,2119,1369.500000000000000,921.496744432664855,5478.000000000000000,4,295,1,25.0000000,295,1,25.0000000,626,2414
2308,4.000000000000000,0.000277777777778,719,1472,753,971.750000000000000,301.168868743102337,3887.000000000000000,4,719,1,25.0000000,719,1,25.0000000,753,1472
2309,4.000000000000000,0.000277777777778,1108,4015,2907,2146.250000000000000,1122.281465364192854,8585.000000000000000,4,1108,1,25.0000000,1108,1,25.0000000,1483,4015
2310,4.000000000000000,0.000277777777778,1108,4015,2907,2146.250000000000000,1122.281465364192854,8585.000000000000000,4,1108,1,25.0000000,1108,1,25.0000000,1483,4015
2311,4.000000000000000,0.000277777777778,657,1963,1306,1104.500000000000000,517.606752274349674,4418.000000000000000,4,657,1,25.0000000,657,1,25.0000000,741,1963
2312,4.000000000000000,0.000277777777778,706,1950,1244,1154.500000000000000,479.627198978539980,4618.000000000000000,4,706,1,25.0000000,706,1,25.0000000,867,1950
2313,4.000000000000000,0.000277777777778,609,1950,1341,1090.000000000000000,528.782091224731289,4360.000000000000000,4,609,1,25.0000000,609,1,25.0000000,706,1950
2314,5.000000000000000,0.000347222222222,5,274,269,162.599999999999994,127.521919684421320,813.000000000000000,4,263,2,40.0000000,5,1,20.0000000,263,274
2315,4.000000000000000,0.000277777777778,0,541,541,241.250000000000000,244.770683497840508,965.000000000000000,3,0,2,50.0000000,424,1,25.0000000,0,541
2316,5.000000000000000,0.000347222222222,133,1383,1250,859.600000000000023,493.761723911442971,4298.000000000000000,5,133,1,20.0000000,133,1,20.0000000,1144,1383
2317,5.000000000000000,0.000347222222222,133,1383,1250,859.600000000000023,493.761723911442971,4298.000000000000000,5,133,1,20.0000000,133,1,20.0000000,1144,1383
2318,4.000000000000000,0.000277777777778,295,3654,3359,1813.000000000000000,1360.160836077851400,7252.000000000000000,4,295,1,25.0000000,295,1,25.0000000,742,3654
2319,4.000000000000000,0.000277777777778,355,1214,859,801.500000000000000,343.766272342124921,3206.000000000000000,4,355,1,25.0000000,355,1,25.0000000,592,1214
2320,4.000000000000000,0.000277777777778,795,1398,603,1114.750000000000000,267.062141644973735,4459.000000000000000,4,795,1,25.0000000,795,1,25.0000000,907,1398
2321,4.000000000000000,0.000277777777778,427,1745,1318,990.500000000000000,572.679011314366221,3962.000000000000000,4,427,1,25.0000000,427,1,25.0000000,444,1745
2322,4.000000000000000,0.000277777777778,245,1845,1600,930.750000000000000,612.102268824417934,3723.000000000000000,4,245,1,25.0000000,245,1,25.0000000,528,1845
2323,4.000000000000000,0.000277777777778,403,3582,3179,1252.500000000000000,1345.782764787839142,5010.000000000000000,4,403,1,25.0000000,403,1,25.0000000,489,3582
2324,4.000000000000000,0.000277777777778,6,663,657,319.750000000000000,274.951245678211080,1279.000000000000000,4,6,1,25.0000000,6,1,25.0000000,98,663
2325,3.000000000000000,0.000208333333333,1020,1318,298,1128.000000000000000,134.768938063140752,3384.000000000000000,3,1020,1,33.3333015,1020,1,33.3333015,1046,1318
2326,4.000000000000000,0.000277777777778,79,2378,2299,1231.750000000000000,940.105147044733599,4927.000000000000000,4,79,1,25.0000000,79,1,25.0000000,567,2378
2327,4.000000000000000,0.000277777777778,281,850,569,687.000000000000000,235.181844537370722,2748.000000000000000,4,281,1,25.0000000,281,1,25.0000000,796,850
2328,4.000000000000000,0.000277777777778,1484,2091,607,1874.500000000000000,247.740287397911942,7498.000000000000000,4,1484,1,25.0000000,1484,1,25.0000000,1837,2091
2329,4.000000000000000,0.000277777777778,1484,2091,607,1874.500000000000000,247.740287397911942,7498.000000000000000,4,1484,1,25.0000000,1484,1,25.0000000,1837,2091
2330,4.000000000000000,0.000277777777778,616,2274,1658,1340.750000000000000,672.600689488198441,5363.000000000000000,4,616,1,25.0000000,616,1,25.0000000,794,2274
2331,4.000000000000000,0.000277777777778,908,2778,1870,1637.250000000000000,732.162336848871291,6549.000000000000000,4,908,1,25.0000000,908,1,25.0000000,1095,2778
2332,4.000000000000000,0.000277777777778,211,3654,3443,1680.250000000000000,1478.937350769125715,6721.000000000000000,4,211,1,25.0000000,211,1,25.0000000,295,3654
2333,4.000000000000000,0.000277777777778,365,1835,1470,1389.500000000000000,604.671191640547704,5558.000000000000000,4,365,1,25.0000000,365,1,25.0000000,1526,1835
2334,4.000000000000000,0.000277777777778,1200,3812,2612,2316.750000000000000,1009.424929105676483,9267.000000000000000,4,1200,1,25.0000000,1200,1,25.0000000,1617,3812
2335,4.000000000000000,0.000277777777778,1200,3812,2612,2316.750000000000000,1009.424929105676483,9267.000000000000000,4,1200,1,25.0000000,1200,1,25.0000000,1617,3812
2336,4.000000000000000,0.000277777777778,430,930,500,718.250000000000000,218.550194463422969,2873.000000000000000,3,930,2,50.0000000,430,1,25.0000000,583,930
2337,3.000000000000000,0.000208333333333,26,767,741,460.000000000000000,315.559820002483832,1380.000000000000000,3,26,1,33.3333015,26,1,33.3333015,587,767
2338,4.000000000000000,0.000277777777778,61,964,903,487.999999999999943,426.062788799960799,1952.000000000000000,4,61,1,25.0000000,61,1,25.0000000,66,964
2339,5.000000000000000,0.000347222222222,329,2320,1991,1004.799999999999955,701.078141151184468,5024.000000000000000,5,329,1,20.0000000,329,1,20.0000000,859,2320
2340,3.000000000000000,0.000208333333333,0,0,0,0.000000000000000,0.000000000000000,0.000000000000000,1,0,3,100.0000000,0,3,100.0000000,0,0
2341,4.000000000000000,0.000277777777778,1008,10385,9377,4453.500000000000000,3541.742544285227723,17814.000000000000000,4,1008,1,25.0000000,1008,1,25.0000000,3085,10385
2342,4.000000000000000,0.000277777777778,638,5023,4385,1854.500000000000000,1832.873495361859568,7418.000000000000000,4,638,1,25.0000000,638,1,25.0000000,797,5023
2343,4.000000000000000,0.000277777777778,47,482,435,239.500000000000000,174.626028987662664,958.000000000000000,4,47,1,25.0000000,47,1,25.0000000,103,482
2344,4.000000000000000,0.000277777777778,387,1266,879,760.500000000000000,329.301153960929810,3042.000000000000000,4,387,1,25.0000000,387,1,25.0000000,572,1266
2345,4.000000000000000,0.000277777777778,24,931,907,260.250000000000000,387.544432936405428,1041.000000000000000,4,24,1,25.0000000,24,1,25.0000000,25,931
2346,4.000000000000000,0.000277777777778,866,4856,3990,2664.500000000000000,1764.090913190133733,10658.000000000000000,4,866,1,25.0000000,866,1,25.0000000,996,4856
2347,4.000000000000000,0.000277777777778,488,1484,996,1104.500000000000000,385.243105064840847,4418.000000000000000,4,488,1,25.0000000,488,1,25.0000000,1079,1484
2348,3.000000000000000,0.000208333333333,1079,1484,405,1310.000000000000000,170.182255244194010,3930.000000000000000,3,1079,1,33.3333015,1079,1,33.3333015,1367,1484
2349,4.000000000000000,0.000277777777778,488,1484,996,1104.500000000000000,385.243105064840847,4418.000000000000000,4,488,1,25.0000000,488,1,25.0000000,1079,1484
2350,4.000000000000000,0.000277777777778,488,1484,996,1104.500000000000000,385.243105064840847,4418.000000000000000,4,488,1,25.0000000,488,1,25.0000000,1079,1484
2351,4.000000000000000,0.000277777777778,488,1484,996,1104.500000000000000,385.243105064840847,4418.000000000000000,4,488,1,25.0000000,488,1,25.0000000,1079,1484
2352,4.000000000000000,0.000277777777778,251,1207,956,796.500000000000000,347.538127404749673,3186.000000000000000,4,251,1,25.0000000,251,1,25.0000000,801,1207
2353,4.000000000000000,0.000277777777778,801,3356,2555,1622.250000000000000,1026.025188530963987,6489.000000000000000,4,801,1,25.0000000,801,1,25.0000000,927,3356
2354,4.000000000000000,0.000277777777778,500,4129,3629,1821.000000000000000,1468.523918770137016,7284.000000000000000,4,500,1,25.0000000,500,1,25.0000000,597,4129
2355,5.000000000000000,0.000347222222222,258,901,643,541.399999999999977,234.091947747033771,2707.000000000000000,5,258,1,20.0000000,258,1,20.0000000,616,901
2356,4.000000000000000,0.000277777777778,824,1933,1109,1318.500000000000000,422.191011273333459,5274.000000000000000,4,824,1,25.0000000,824,1,25.0000000,1054,1933
2357,4.000000000000000,0.000277777777778,616,2274,1658,1340.750000000000000,672.600689488198441,5363.000000000000000,4,616,1,25.0000000,616,1,25.0000000,794,2274
2358,4.000000000000000,0.000277777777778,794,3612,2818,1901.750000000000000,1144.636705465974501,7607.000000000000000,4,794,1,25.0000000,794,1,25.0000000,927,3612
2359,5.000000000000000,0.000347222222222,270,1344,1074,994.000000000000000,418.547966187867189,4970.000000000000000,5,270,1,20.0000000,270,1,20.0000000,1244,1344
2360,4.000000000000000,0.000277777777778,140,624,484,471.250000000000000,193.594130851118535,1885.000000000000000,4,140,1,25.0000000,140,1,25.0000000,539,624
2361,3.000000000000000,0.000208333333333,686,871,185,765.666666666666629,77.675965108620019,2297.000000000000000,3,686,1,33.3333015,686,1,33.3333015,740,871
2362,4.000000000000000,0.000277777777778,26534,77116,50582,45360.500000000000000,19297.060430283156165,181442.000000000000000,4,26534,1,25.0000000,26534,1,25.0000000,34255,77116
2363,4.000000000000000,0.000277777777778,281,821,540,657.500000000000000,219.782278630466493,2630.000000000000000,4,281,1,25.0000000,281,1,25.0000000,732,821
2364,4.000000000000000,0.000277777777778,579,1826,1247,1146.000000000000000,457.547265318021516,4584.000000000000000,4,579,1,25.0000000,579,1,25.0000000,936,1826
2365,4.000000000000000,0.000277777777778,820,1157,337,988.750000000000000,159.989648102619441,3955.000000000000000,4,820,1,25.0000000,820,1,25.0000000,838,1157
2366,3.000000000000000,0.000208333333333,969,1259,290,1065.666666666666742,136.707311029399193,3197.000000000000000,2,969,2,66.6667023,1259,1,33.3333015,969,1259
2367,4.000000000000000,0.000277777777778,17,868,851,440.000000000000000,386.244093805976547,1760.000000000000000,4,17,1,25.0000000,17,1,25.0000000,95,868
2368,4.000000000000000,0.000277777777778,73,875,802,587.500000000000000,325.949766068331428,2350.000000000000000,4,73,1,25.0000000,73,1,25.0000000,540,875
2369,4.000000000000000,0.000277777777778,6,852,846,309.500000000000000,339.108758365218307,1238.000000000000000,4,6,1,25.0000000,6,1,25.0000000,40,852
2370,4.000000000000000,0.000277777777778,513,2151,1638,1024.500000000000000,661.721051501310512,4098.000000000000000,4,513,1,25.0000000,513,1,25.0000000,591,2151
2371,3.000000000000000,0.000208333333333,562,2151,1589,1101.333333333333485,742.320835099097962,3304.000000000000000,3,562,1,33.3333015,562,1,33.3333015,591,2151
2372,4.000000000000000,0.000277777777778,686,1832,1146,1459.000000000000000,461.528980671853390,5836.000000000000000,4,686,1,25.0000000,686,1,25.0000000,1526,1832
2373,5.000000000000000,0.000347222222222,384,1792,1408,1006.799999999999955,549.013078168453148,5034.000000000000000,5,384,1,20.0000000,384,1,20.0000000,686,1792
2374,4.000000000000000,0.000277777777778,411,2229,1818,1168.000000000000000,692.220340643064333,4672.000000000000000,4,411,1,25.0000000,411,1,25.0000000,723,2229
2375,4.000000000000000,0.000277777777778,723,2955,2232,1715.250000000000000,917.194192905733530,6861.000000000000000,4,723,1,25.0000000,723,1,25.0000000,954,2955
2376,4.000000000000000,0.000277777777778,445,1715,1270,1024.000000000000000,515.411486096303406,4096.000000000000000,4,445,1,25.0000000,445,1,25.0000000,619,1715
2377,4.000000000000000,0.000277777777778,61,938,877,431.250000000000000,322.243987531187258,1725.000000000000000,4,61,1,25.0000000,61,1,25.0000000,285,938
2378,4.000000000000000,0.000277777777778,0,1596,1596,738.500000000000000,743.278379881992805,2954.000000000000000,3,0,2,50.0000000,1358,1,25.0000000,0,1596
2379,4.000000000000000,0.000277777777778,0,2009,2009,1181.250000000000000,751.047726512769600,4725.000000000000000,4,0,1,25.0000000,0,1,25.0000000,1120,2009
2380,4.000000000000000,0.000277777777778,52,1898,1846,981.250000000000000,671.054161375965236,3925.000000000000000,4,52,1,25.0000000,52,1,25.0000000,767,1898
2381,4.000000000000000,0.000277777777778,52,1898,1846,981.250000000000000,671.054161375965236,3925.000000000000000,4,52,1,25.0000000,52,1,25.0000000,767,1898
2382,4.000000000000000,0.000277777777778,52,1898,1846,981.250000000000000,671.054161375965236,3925.000000000000000,4,52,1,25.0000000,52,1,25.0000000,767,1898
2383,4.000000000000000,0.000277777777778,483,1393,910,998.000000000000000,328.689823389772755,3992.000000000000000,4,483,1,25.0000000,483,1,25.0000000,1015,1393
2384,4.000000000000000,0.000277777777778,654,1772,1118,1251.500000000000000,397.787317545444125,5006.000000000000000,4,654,1,25.0000000,654,1,25.0000000,1258,1772
2385,4.000000000000000,0.000277777777778,518,9029,8511,3257.500000000000000,3381.825135928822874,13030.000000000000000,4,518,1,25.0000000,518,1,25.0000000,1332,9029
2386,4.000000000000000,0.000277777777778,23,3897,3874,1430.250000000000000,1489.427973250133391,5721.000000000000000,4,23,1,25.0000000,23,1,25.0000000,549,3897
2387,4.000000000000000,0.000277777777778,135,2343,2208,936.750000000000000,839.245606184506642,3747.000000000000000,4,135,1,25.0000000,135,1,25.0000000,550,2343
2388,4.000000000000000,0.000277777777778,12,4415,4403,1320.750000000000000,1797.367015247581548,5283.000000000000000,4,12,1,25.0000000,12,1,25.0000000,285,4415
2389,4.000000000000000,0.000277777777778,270,1338,1068,793.250000000000000,499.184021679380294,3173.000000000000000,4,270,1,25.0000000,270,1,25.0000000,321,1338
2390,4.000000000000000,0.000277777777778,651,1294,643,1030.750000000000000,259.010979497008975,4123.000000000000000,4,651,1,25.0000000,651,1,25.0000000,934,1294
2391,4.000000000000000,0.000277777777778,315,2989,2674,1145.500000000000000,1093.036481550364442,4582.000000000000000,4,315,1,25.0000000,315,1,25.0000000,341,2989
2392,4.000000000000000,0.000277777777778,140,977,837,595.250000000000000,305.362387173011200,2381.000000000000000,4,140,1,25.0000000,140,1,25.0000000,539,977
2393,3.000000000000000,0.000208333333333,82,3014,2932,1406.333333333333485,1213.634852645372803,4219.000000000000000,3,82,1,33.3333015,82,1,33.3333015,1123,3014
2394,3.000000000000000,0.000208333333333,75,2577,2502,938.333333333333371,1159.269118405596600,2815.000000000000000,3,75,1,33.3333015,75,1,33.3333015,163,2577
2395,4.000000000000000,0.000277777777778,75,2577,2502,735.500000000000000,1063.650671038193877,2942.000000000000000,4,75,1,25.0000000,75,1,25.0000000,127,2577
2396,3.000000000000000,0.000208333333333,699,2478,1779,1617.000000000000000,727.391228982038228,4851.000000000000000,3,699,1,33.3333015,699,1,33.3333015,1674,2478
2397,5.000000000000000,0.000347222222222,45,2957,2912,635.199999999999932,1160.944167477489145,3176.000000000000000,5,45,1,20.0000000,45,1,20.0000000,51,2957
2398,4.000000000000000,0.000277777777778,1075,2433,1358,1790.750000000000000,491.815196491527672,7163.000000000000000,4,1075,1,25.0000000,1075,1,25.0000000,1686,2433
2399,4.000000000000000,0.000277777777778,31,3886,3855,2086.750000000000000,1534.684556350261801,8347.000000000000000,4,31,1,25.0000000,31,1,25.0000000,1234,3886
2400,4.000000000000000,0.000277777777778,31,3886,3855,2086.750000000000000,1534.684556350261801,8347.000000000000000,4,31,1,25.0000000,31,1,25.0000000,1234,3886
2401,4.000000000000000,0.000277777777778,1047,2651,1604,1910.000000000000000,730.298226753974859,7640.000000000000000,4,1047,1,25.0000000,1047,1,25.0000000,1326,2651
2402,4.000000000000000,0.000277777777778,781,1406,625,1073.250000000000000,221.951993683318818,4293.000000000000000,4,781,1,25.0000000,781,1,25.0000000,1046,1406
2403,4.000000000000000,0.000277777777778,830,3908,3078,1823.250000000000000,1242.106954935846034,7293.000000000000000,4,830,1,25.0000000,830,1,25.0000000,929,3908
2404,4.000000000000000,0.000277777777778,328,1227,899,731.500000000000000,338.328612446538443,2926.000000000000000,4,328,1,25.0000000,328,1,25.0000000,535,1227
2405,4.000000000000000,0.000277777777778,339,1363,1024,848.500000000000000,366.331475579153562,3394.000000000000000,4,339,1,25.0000000,339,1,25.0000000,767,1363
2406,4.000000000000000,0.000277777777778,321,879,558,629.250000000000000,202.864948919225583,2517.000000000000000,4,321,1,25.0000000,321,1,25.0000000,606,879
2407,4.000000000000000,0.000277777777778,615,967,352,769.250000000000000,153.581208160373592,3077.000000000000000,4,615,1,25.0000000,615,1,25.0000000,624,967
2408,4.000000000000000,0.000277777777778,7,61,54,31.749999999999996,24.076700355322778,127.000000000000000,4,7,1,25.0000000,7,1,25.0000000,9,61
2409,4.000000000000000,0.000277777777778,423,1871,1448,1282.000000000000000,535.980410089771794,5128.000000000000000,4,423,1,25.0000000,423,1,25.0000000,1299,1871
2410,5.000000000000000,0.000347222222222,27,2274,2247,841.000000000000000,770.726670097772057,4205.000000000000000,5,27,1,20.0000000,27,1,20.0000000,509,2274
2411,4.000000000000000,0.000277777777778,347,689,342,542.000000000000000,128.050771180809363,2168.000000000000000,4,347,1,25.0000000,347,1,25.0000000,517,689
2412,4.000000000000000,0.000277777777778,379,1598,1219,900.250000000000000,440.108154321184998,3601.000000000000000,4,379,1,25.0000000,379,1,25.0000000,794,1598
2413,5.000000000000000,0.000347222222222,33,454,421,279.199999999999989,146.308441314915257,1396.000000000000000,5,33,1,20.0000000,33,1,20.0000000,287,454
2414,4.000000000000000,0.000277777777778,20,1184,1164,717.750000000000000,440.551004425140320,2871.000000000000000,4,20,1,25.0000000,20,1,25.0000000,683,1184
2415,5.000000000000000,0.000347222222222,1,1184,1183,440.600000000000023,446.615987174664383,2203.000000000000000,5,1,1,20.0000000,1,1,20.0000000,315,1184
2416,4.000000000000000,0.000277777777778,518,2387,1869,1438.750000000000000,836.882421550363347,5755.000000000000000,4,518,1,25.0000000,518,1,25.0000000,699,2387
2417,4.000000000000000,0.000277777777778,764,1047,283,938.250000000000000,106.045685909423014,3753.000000000000000,4,764,1,25.0000000,764,1,25.0000000,953,1047
2418,4.000000000000000,0.000277777777778,809,4410,3601,1850.000000000000000,1486.445929053593318,7400.000000000000000,4,809,1,25.0000000,809,1,25.0000000,937,4410
2419,4.000000000000000,0.000277777777778,678,1265,587,959.500000000000000,223.350061562561450,3838.000000000000000,4,678,1,25.0000000,678,1,25.0000000,832,1265
2420,4.000000000000000,0.000277777777778,679,4364,3685,1627.000000000000000,1580.631044867840046,6508.000000000000000,4,679,1,25.0000000,679,1,25.0000000,691,4364
2421,4.000000000000000,0.000277777777778,0,1696,1696,789.000000000000000,610.600524074455734,3156.000000000000000,4,0,1,25.0000000,0,1,25.0000000,590,1696
2422,4.000000000000000,0.000277777777778,4,529,525,221.250000000000000,207.637153467292563,885.000000000000000,4,4,1,25.0000000,4,1,25.0000000,61,529
2423,5.000000000000000,0.000347222222222,553,1196,643,855.200000000000045,206.774659956194824,4276.000000000000000,5,553,1,20.0000000,553,1,20.0000000,850,1196
2424,4.000000000000000,0.000277777777778,420,1617,1197,828.500000000000000,464.695868283762593,3314.000000000000000,4,420,1,25.0000000,420,1,25.0000000,600,1617
2425,4.000000000000000,0.000277777777778,74,258,184,158.250000000000000,67.098342006341710,633.000000000000000,4,74,1,25.0000000,74,1,25.0000000,130,258
2426,4.000000000000000,0.000277777777778,74,1183,1109,421.499999999999943,444.443753471685113,1686.000000000000000,4,74,1,25.0000000,74,1,25.0000000,171,1183
2427,4.000000000000000,0.000277777777778,12,3052,3040,1147.000000000000000,1256.466075944750628,4588.000000000000000,4,12,1,25.0000000,12,1,25.0000000,20,3052
2428,4.000000000000000,0.000277777777778,12,3052,3040,1147.000000000000000,1256.466075944750628,4588.000000000000000,4,12,1,25.0000000,12,1,25.0000000,20,3052
2429,4.000000000000000,0.000277777777778,324,977,653,632.750000000000000,237.706094789342757,2531.000000000000000,4,324,1,25.0000000,324,1,25.0000000,539,977
2430,4.000000000000000,0.000277777777778,94,852,758,300.250000000000000,319.355894731880596,1201.000000000000000,4,94,1,25.0000000,94,1,25.0000000,102,852
2431,4.000000000000000,0.000277777777778,295,700,405,521.250000000000000,145.255593696077682,2085.000000000000000,4,295,1,25.0000000,295,1,25.0000000,537,700
2432,5.000000000000000,0.000347222222222,207,1621,1414,813.200000000000045,613.775985193295014,4066.000000000000000,5,207,1,20.0000000,207,1,20.0000000,528,1621
2433,4.000000000000000,0.000277777777778,315,1243,928,809.500000000000000,333.314791150947883,3238.000000000000000,4,315,1,25.0000000,315,1,25.0000000,769,1243
2434,4.000000000000000,0.000277777777778,332,1534,1202,972.250000000000000,530.869275339984256,3889.000000000000000,4,332,1,25.0000000,332,1,25.0000000,565,1534
2435,4.000000000000000,0.000277777777778,64,1104,1040,600.750000000000000,503.807192783112271,2403.000000000000000,3,1104,2,50.0000000,64,1,25.0000000,131,1104
2436,4.000000000000000,0.000277777777778,0,33,33,11.000000000000000,12.942179105544785,44.000000000000000,4,0,1,25.0000000,0,1,25.0000000,4,33
2437,4.000000000000000,0.000277777777778,0,33,33,11.000000000000000,12.942179105544785,44.000000000000000,4,0,1,25.0000000,0,1,25.0000000,4,33
2438,4.000000000000000,0.000277777777778,0,33,33,11.000000000000000,12.942179105544785,44.000000000000000,4,0,1,25.0000000,0,1,25.0000000,4,33
2439,4.000000000000000,0.000277777777778,46,1438,1392,604.750000000000000,517.637602478799863,2419.000000000000000,4,46,1,25.0000000,46,1,25.0000000,350,1438
2440,4.000000000000000,0.000277777777778,137,826,689,389.000000000000000,283.094507187970692,1556.000000000000000,4,137,1,25.0000000,137,1,25.0000000,140,826
2441,4.000000000000000,0.000277777777778,137,826,689,442.750000000000000,309.337497726997185,1771.000000000000000,4,137,1,25.0000000,137,1,25.0000000,140,826
2442,4.000000000000000,0.000277777777778,120,929,809,542.250000000000000,308.884586051165741,2169.000000000000000,4,120,1,25.0000000,120,1,25.0000000,397,929
2443,4.000000000000000,0.000277777777778,285,1619,1334,897.250000000000000,481.425162927738938,3589.000000000000000,4,285,1,25.0000000,285,1,25.0000000,730,1619
2444,4.000000000000000,0.000277777777778,285,1619,1334,1057.750000000000000,572.353638496340864,4231.000000000000000,4,285,1,25.0000000,285,1,25.0000000,730,1619
2445,4.000000000000000,0.000277777777778,285,1227,942,799.250000000000000,345.136476629173501,3197.000000000000000,4,285,1,25.0000000,285,1,25.0000000,730,1227
2446,4.000000000000000,0.000277777777778,291,1489,1198,852.250000000000000,439.221683777110457,3409.000000000000000,4,291,1,25.0000000,291,1,25.0000000,659,1489
2447,4.000000000000000,0.000277777777778,124,1395,1271,769.250000000000000,506.759990034730322,3077.000000000000000,4,124,1,25.0000000,124,1,25.0000000,448,1395
2448,4.000000000000000,0.000277777777778,124,1395,1271,769.250000000000000,506.759990034730322,3077.000000000000000,4,124,1,25.0000000,124,1,25.0000000,448,1395
2449,4.000000000000000,0.000277777777778,44,1696,1652,502.000000000000000,690.973226688270529,2008.000000000000000,4,44,1,25.0000000,44,1,25.0000000,92,1696
2450,4.000000000000000,0.000277777777778,242,1266,1024,609.750000000000000,396.530184853561934,2439.000000000000000,4,242,1,25.0000000,242,1,25.0000000,362,1266
2451,4.000000000000000,0.000277777777778,200,2561,2361,1505.000000000000000,901.094612124609284,6020.000000000000000,4,200,1,25.0000000,200,1,25.0000000,1183,2561
2452,4.000000000000000,0.000277777777778,153,1698,1545,817.750000000000000,558.899532563769412,3271.000000000000000,4,153,1,25.0000000,153,1,25.0000000,641,1698
2453,4.000000000000000,0.000277777777778,43,1698,1655,790.250000000000000,592.620188231889415,3161.000000000000000,4,43,1,25.0000000,43,1,25.0000000,641,1698
2454,3.000000000000000,0.000208333333333,654,748,94,705.666666666666629,38.938698260499443,2117.000000000000000,3,654,1,33.3333015,654,1,33.3333015,715,748
2455,4.000000000000000,0.000277777777778,29,4757,4728,2280.000000000000000,2183.395749743962369,9120.000000000000000,4,29,1,25.0000000,29,1,25.0000000,187,4757
2456,5.000000000000000,0.000347222222222,592,2726,2134,1697.400000000000091,716.561400020961173,8487.000000000000000,5,592,1,20.0000000,592,1,20.0000000,1615,2726
2457,4.000000000000000,0.000277777777778,20,273,253,96.000000000000000,102.793482283654541,384.000000000000000,4,20,1,25.0000000,20,1,25.0000000,40,273
2458,4.000000000000000,0.000277777777778,95,916,821,507.750000000000000,364.171233762360771,2031.000000000000000,4,95,1,25.0000000,95,1,25.0000000,199,916
2459,4.000000000000000,0.000277777777778,752,1126,374,913.250000000000000,141.776893392400154,3653.000000000000000,4,752,1,25.0000000,752,1,25.0000000,825,1126
2460,3.000000000000000,0.000208333333333,285,4415,4130,1757.000000000000000,1883.113025462536143,5271.000000000000000,3,285,1,33.3333015,285,1,33.3333015,571,4415
2461,4.000000000000000,0.000277777777778,266,2056,1790,1335.000000000000000,663.455348912042496,5340.000000000000000,4,266,1,25.0000000,266,1,25.0000000,1372,2056
2462,4.000000000000000,0.000277777777778,603,4401,3798,2091.750000000000000,1595.114631460698547,8367.000000000000000,4,603,1,25.0000000,603,1,25.0000000,611,4401
2463,4.000000000000000,0.000277777777778,25,351,326,158.250000000000000,122.268914692165325,633.000000000000000,4,25,1,25.0000000,25,1,25.0000000,89,351
2464,4.000000000000000,0.000277777777778,691,4150,3459,1867.000000000000000,1382.640047156164201,7468.000000000000000,4,691,1,25.0000000,691,1,25.0000000,845,4150
2465,3.000000000000000,0.000208333333333,966,2430,1464,1730.666666666666742,599.458273962602220,5192.000000000000000,3,966,1,33.3333015,966,1,33.3333015,1796,2430
2466,5.000000000000000,0.000347222222222,89,3184,3095,1222.000000000000000,1132.925240251977129,6110.000000000000000,5,89,1,20.0000000,89,1,20.0000000,696,3184
2467,4.000000000000000,0.000277777777778,52,2364,2312,1238.500000000000000,818.630716501647044,4954.000000000000000,4,52,1,25.0000000,52,1,25.0000000,1223,2364
2468,6.000000000000000,0.000416666666667,475,2951,2476,1124.500000000000000,843.496640973355284,6747.000000000000000,6,475,1,16.6667004,475,1,16.6667004,767,1059
2469,4.000000000000000,0.000277777777778,292,797,505,571.000000000000000,182.541776040445058,2284.000000000000000,4,292,1,25.0000000,292,1,25.0000000,559,797
2470,4.000000000000000,0.000277777777778,292,797,505,571.000000000000000,182.541776040445058,2284.000000000000000,4,292,1,25.0000000,292,1,25.0000000,559,797
2471,4.000000000000000,0.000277777777778,536,1100,564,894.000000000000000,214.519229907250974,3576.000000000000000,4,536,1,25.0000000,536,1,25.0000000,939,1100
2472,4.000000000000000,0.000277777777778,1187,3500,2313,2033.750000000000000,925.124687542171273,8135.000000000000000,4,1187,1,25.0000000,1187,1,25.0000000,1297,3500
2473,4.000000000000000,0.000277777777778,1187,9368,8181,3500.750000000000000,3407.946623334937158,14003.000000000000000,4,1187,1,25.0000000,1187,1,25.0000000,1297,9368
2474,4.000000000000000,0.000277777777778,1187,9368,8181,3838.000000000000000,3323.387804635504835,15352.000000000000000,4,1187,1,25.0000000,1187,1,25.0000000,1297,9368
2475,4.000000000000000,0.000277777777778,44,1925,1881,779.000000000000000,707.286010041199688,3116.000000000000000,4,44,1,25.0000000,44,1,25.0000000,396,1925
2476,3.000000000000000,0.000208333333333,41,784,743,453.000000000000000,308.688624129018820,1359.000000000000000,3,41,1,33.3333015,41,1,33.3333015,534,784
2477,5.000000000000000,0.000347222222222,41,1509,1468,693.799999999999955,476.021596148746198,3469.000000000000000,5,41,1,20.0000000,41,1,20.0000000,601,1509
2478,4.000000000000000,0.000277777777778,41,1509,1468,717.000000000000000,529.673956316524936,2868.000000000000000,4,41,1,25.0000000,41,1,25.0000000,534,1509
2479,4.000000000000000,0.000277777777778,666,1077,411,861.750000000000000,195.290008705002634,3447.000000000000000,4,666,1,25.0000000,666,1,25.0000000,668,1077
2480,4.000000000000000,0.000277777777778,396,933,537,622.250000000000000,214.829438159671213,2489.000000000000000,4,396,1,25.0000000,396,1,25.0000000,451,933
2481,4.000000000000000,0.000277777777778,211,3654,3443,1659.500000000000000,1466.968387525784465,6638.000000000000000,4,211,1,25.0000000,211,1,25.0000000,295,3654
2482,4.000000000000000,0.000277777777778,211,3654,3443,1659.500000000000000,1466.968387525784465,6638.000000000000000,4,211,1,25.0000000,211,1,25.0000000,295,3654
2483,4.000000000000000,0.000277777777778,749,2305,1556,1339.500000000000000,583.491859411937298,5358.000000000000000,4,749,1,25.0000000,749,1,25.0000000,1079,2305
2484,4.000000000000000,0.000277777777778,749,2305,1556,1339.500000000000000,583.491859411937298,5358.000000000000000,4,749,1,25.0000000,749,1,25.0000000,1079,2305
2485,4.000000000000000,0.000277777777778,772,1808,1036,1289.000000000000000,393.923215868270461,5156.000000000000000,4,772,1,25.0000000,772,1,25.0000000,1083,1808
2486,4.000000000000000,0.000277777777778,772,1808,1036,1364.250000000000000,450.405581115509733,5457.000000000000000,4,772,1,25.0000000,772,1,25.0000000,1083,1808
2487,4.000000000000000,0.000277777777778,209,1248,1039,550.000000000000000,419.181941404922668,2200.000000000000000,4,209,1,25.0000000,209,1,25.0000000,238,1248
2488,5.000000000000000,0.000347222222222,584,2829,2245,1440.400000000000091,768.854888779410771,7202.000000000000000,5,584,1,20.0000000,584,1,20.0000000,1202,2829
2489,4.000000000000000,0.000277777777778,100,1556,1456,549.250000000000000,587.285865230894160,2197.000000000000000,4,100,1,25.0000000,100,1,25.0000000,204,1556
2490,4.000000000000000,0.000277777777778,339,1996,1657,1257.000000000000000,609.854490841872916,5028.000000000000000,4,339,1,25.0000000,339,1,25.0000000,1143,1996
2491,5.000000000000000,0.000347222222222,0,2296,2296,980.200000000000045,881.486108795822133,4901.000000000000000,4,0,2,40.0000000,1192,1,20.0000000,1192,2296
2492,3.000000000000000,0.000208333333333,0,1413,1413,868.333333333333258,620.597740533717570,2605.000000000000000,3,0,1,33.3333015,0,1,33.3333015,1192,1413
2493,5.000000000000000,0.000347222222222,0,1413,1413,521.000000000000000,641.907781538750328,2605.000000000000000,3,0,3,60.0000000,1192,1,20.0000000,0,1413
2494,4.000000000000000,0.000277777777778,0,1413,1413,651.250000000000000,655.920488702708553,2605.000000000000000,3,0,2,50.0000000,1192,1,25.0000000,0,1413
2495,4.000000000000000,0.000277777777778,402,1174,772,657.250000000000000,302.679182468831186,2629.000000000000000,4,402,1,25.0000000,402,1,25.0000000,520,1174
2496,4.000000000000000,0.000277777777778,72,207,135,135.250000000000000,57.133068358000870,541.000000000000000,4,72,1,25.0000000,72,1,25.0000000,87,207
2497,4.000000000000000,0.000277777777778,622,1753,1131,997.000000000000000,443.295048472233645,3988.000000000000000,4,622,1,25.0000000,622,1,25.0000000,781,1753
2498,4.000000000000000,0.000277777777778,622,2017,1395,1306.000000000000000,591.156070763043090,5224.000000000000000,4,622,1,25.0000000,622,1,25.0000000,832,2017
2499,4.000000000000000,0.000277777777778,147,1226,1079,746.000000000000000,478.821991976141362,2984.000000000000000,4,147,1,25.0000000,147,1,25.0000000,405,1226
2500,5.000000000000000,0.000347222222222,253,977,724,637.399999999999977,261.137971195305113,3187.000000000000000,5,253,1,20.0000000,253,1,20.0000000,752,977
2501,4.000000000000000,0.000277777777778,36,746,710,416.500000000000000,307.673934547598606,1666.000000000000000,4,36,1,25.0000000,36,1,25.0000000,193,746
2502,4.000000000000000,0.000277777777778,295,2561,2266,1524.250000000000000,1007.640653953580795,6097.000000000000000,4,295,1,25.0000000,295,1,25.0000000,767,2561
2503,3.000000000000000,0.000208333333333,295,2561,2266,1207.666666666666742,976.158912381699338,3623.000000000000000,3,295,1,33.3333015,295,1,33.3333015,767,2561
2504,4.000000000000000,0.000277777777778,425,1550,1125,778.500000000000000,449.321989223763694,3114.000000000000000,4,425,1,25.0000000,425,1,25.0000000,566,1550
2505,4.000000000000000,0.000277777777778,412,640,228,516.250000000000000,97.566323595798153,2065.000000000000000,4,412,1,25.0000000,412,1,25.0000000,430,640
2506,3.000000000000000,0.000208333333333,237,899,662,608.000000000000000,276.117124906563276,1824.000000000000000,3,237,1,33.3333015,237,1,33.3333015,688,899
2507,5.000000000000000,0.000347222222222,75,1183,1108,616.399999999999977,410.629565423630936,3082.000000000000000,5,75,1,20.0000000,75,1,20.0000000,688,1183
2508,4.000000000000000,0.000277777777778,237,1183,946,764.250000000000000,343.580685574727852,3057.000000000000000,4,237,1,25.0000000,237,1,25.0000000,738,1183
2509,4.000000000000000,0.000277777777778,962,8038,7076,2760.500000000000000,3047.082251925602577,11042.000000000000000,4,962,1,25.0000000,962,1,25.0000000,1005,8038
2510,4.000000000000000,0.000277777777778,209,894,685,511.750000000000000,264.112073749005276,2047.000000000000000,4,209,1,25.0000000,209,1,25.0000000,334,894
2511,4.000000000000000,0.000277777777778,199,961,762,724.250000000000000,307.435664001429700,2897.000000000000000,4,199,1,25.0000000,199,1,25.0000000,821,961
2512,5.000000000000000,0.000347222222222,295,1244,949,514.200000000000045,366.279346947108138,2571.000000000000000,5,295,1,20.0000000,295,1,20.0000000,335,1244
2513,4.000000000000000,0.000277777777778,219,1244,1025,523.250000000000000,418.205915190112989,2093.000000000000000,4,219,1,25.0000000,219,1,25.0000000,295,1244
2514,4.000000000000000,0.000277777777778,219,1244,1025,523.250000000000000,418.205915190112989,2093.000000000000000,4,219,1,25.0000000,219,1,25.0000000,295,1244
2515,4.000000000000000,0.000277777777778,219,1244,1025,523.250000000000000,418.205915190112989,2093.000000000000000,4,219,1,25.0000000,219,1,25.0000000,295,1244
2516,5.000000000000000,0.000347222222222,39,995,956,521.000000000000000,390.418749549762254,2605.000000000000000,5,39,1,20.0000000,39,1,20.0000000,499,995
2517,4.000000000000000,0.000277777777778,305,2111,1806,1231.750000000000000,693.295526813782317,4927.000000000000000,4,305,1,25.0000000,305,1,25.0000000,875,2111
2518,4.000000000000000,0.000277777777778,20,273,253,128.250000000000000,100.372742813973161,513.000000000000000,4,20,1,25.0000000,20,1,25.0000000,51,273
2519,5.000000000000000,0.000347222222222,20,1392,1372,378.800000000000011,514.841101700320678,1894.000000000000000,5,20,1,20.0000000,20,1,20.0000000,169,1392
2520,4.000000000000000,0.000277777777778,87,9451,9364,3163.250000000000000,3819.433359478863622,12653.000000000000000,4,87,1,25.0000000,87,1,25.0000000,109,9451
2521,4.000000000000000,0.000277777777778,94,3073,2979,1838.750000000000000,1226.760851796306724,7355.000000000000000,4,94,1,25.0000000,94,1,25.0000000,1281,3073
2522,4.000000000000000,0.000277777777778,255,829,574,511.500000000000000,205.366136449026072,2046.000000000000000,4,255,1,25.0000000,255,1,25.0000000,470,829
2523,4.000000000000000,0.000277777777778,60,1073,1013,631.250000000000000,410.991103918320903,2525.000000000000000,4,60,1,25.0000000,60,1,25.0000000,426,1073
2524,4.000000000000000,0.000277777777778,75,997,922,502.000000000000000,357.800223588527103,2008.000000000000000,4,75,1,25.0000000,75,1,25.0000000,265,997
2525,5.000000000000000,0.000347222222222,463,3827,3364,1749.800000000000182,1229.507446093759881,8749.000000000000000,5,463,1,20.0000000,463,1,20.0000000,1668,3827
2526,4.000000000000000,0.000277777777778,43,1391,1348,532.000000000000000,554.590840169579451,2128.000000000000000,3,43,2,50.0000000,651,1,25.0000000,43,1391
2527,4.000000000000000,0.000277777777778,284,1644,1360,1016.000000000000000,598.668940233247781,4064.000000000000000,4,284,1,25.0000000,284,1,25.0000000,569,1644
2528,4.000000000000000,0.000277777777778,192,3712,3520,1264.250000000000000,1422.147385997667925,5057.000000000000000,4,192,1,25.0000000,192,1,25.0000000,539,3712
2529,4.000000000000000,0.000277777777778,337,816,479,552.000000000000000,171.220617917352456,2208.000000000000000,4,337,1,25.0000000,337,1,25.0000000,519,816
2530,4.000000000000000,0.000277777777778,317,816,499,497.250000000000000,200.152910296103357,1989.000000000000000,4,317,1,25.0000000,317,1,25.0000000,337,816
2531,4.000000000000000,0.000277777777778,109,622,513,249.000000000000028,215.693068966065766,996.000000000000000,4,109,1,25.0000000,109,1,25.0000000,122,622
2532,4.000000000000000,0.000277777777778,755,5582,4827,2185.000000000000000,1976.269591933246375,8740.000000000000000,4,755,1,25.0000000,755,1,25.0000000,974,5582
2533,4.000000000000000,0.000277777777778,388,1078,690,813.750000000000000,272.796971207526440,3255.000000000000000,4,388,1,25.0000000,388,1,25.0000000,765,1078
2534,5.000000000000000,0.000347222222222,603,1963,1360,955.000000000000000,509.036737377568841,4775.000000000000000,5,603,1,20.0000000,603,1,20.0000000,739,1963
2535,4.000000000000000,0.000277777777778,24,505,481,221.750000000000000,179.922726468892762,887.000000000000000,4,24,1,25.0000000,24,1,25.0000000,122,505
2536,4.000000000000000,0.000277777777778,274,719,445,568.000000000000000,173.422893529084007,2272.000000000000000,4,274,1,25.0000000,274,1,25.0000000,619,719
2537,3.000000000000000,0.000208333333333,765,1382,617,1056.666666666666742,253.011637852666524,3170.000000000000000,3,765,1,33.3333015,765,1,33.3333015,1023,1382
2538,4.000000000000000,0.000277777777778,141,343,202,252.750000000000000,72.264704386027901,1011.000000000000000,4,141,1,25.0000000,141,1,25.0000000,260,343
2539,4.000000000000000,0.000277777777778,425,5515,5090,1906.750000000000000,2093.335660494990861,7627.000000000000000,4,425,1,25.0000000,425,1,25.0000000,682,5515
2540,3.000000000000000,0.000208333333333,430,930,500,636.333333333333258,213.260925211868624,1909.000000000000000,3,430,1,33.3333015,430,1,33.3333015,549,930
2541,4.000000000000000,0.000277777777778,563,1605,1042,845.000000000000000,439.412676194030610,3380.000000000000000,4,563,1,25.0000000,563,1,25.0000000,584,1605
2542,4.000000000000000,0.000277777777778,593,1694,1101,1303.250000000000000,431.149263596726996,5213.000000000000000,4,593,1,25.0000000,593,1,25.0000000,1330,1694
2543,4.000000000000000,0.000277777777778,157,938,781,437.750000000000000,305.598899703516622,1751.000000000000000,4,157,1,25.0000000,157,1,25.0000000,227,938
2544,5.000000000000000,0.000347222222222,335,661,326,546.799999999999955,117.927774506262949,2734.000000000000000,5,335,1,20.0000000,335,1,20.0000000,602,661
2545,3.000000000000000,0.000208333333333,397,2941,2544,1269.333333333333485,1182.422466332946897,3808.000000000000000,3,397,1,33.3333015,397,1,33.3333015,470,2941
2546,4.000000000000000,0.000277777777778,577,697,120,629.000000000000000,44.141816908686486,2516.000000000000000,4,577,1,25.0000000,577,1,25.0000000,608,697
2547,4.000000000000000,0.000277777777778,83,3069,2986,1234.250000000000000,1115.950575742492219,4937.000000000000000,4,83,1,25.0000000,83,1,25.0000000,725,3069
2548,4.000000000000000,0.000277777777778,4,174,170,73.500000000000000,71.086215260062900,294.000000000000000,4,4,1,25.0000000,4,1,25.0000000,9,174
2549,4.000000000000000,0.000277777777778,272,610,338,412.500000000000000,143.912299682827665,1650.000000000000000,4,272,1,25.0000000,272,1,25.0000000,278,610
2550,3.000000000000000,0.000208333333333,46,2228,2182,800.666666666666742,1009.832109258211744,2402.000000000000000,3,46,1,33.3333015,46,1,33.3333015,128,2228
2551,4.000000000000000,0.000277777777778,524,1747,1223,1272.500000000000000,464.791619976092136,5090.000000000000000,4,524,1,25.0000000,524,1,25.0000000,1266,1747
2552,4.000000000000000,0.000277777777778,427,1745,1318,990.500000000000000,572.679011314366221,3962.000000000000000,4,427,1,25.0000000,427,1,25.0000000,444,1745
2553,3.000000000000000,0.000208333333333,427,1745,1318,872.000000000000000,617.343232462028936,2616.000000000000000,3,427,1,33.3333015,427,1,33.3333015,444,1745
2554,5.000000000000000,0.000347222222222,12,3052,3040,952.799999999999955,1189.041698175467673,4764.000000000000000,5,12,1,20.0000000,12,1,20.0000000,176,3052
2555,3.000000000000000,0.000208333333333,43,1104,1061,489.666666666666629,449.083758582095982,1469.000000000000000,3,43,1,33.3333015,43,1,33.3333015,322,1104
2556,4.000000000000000,0.000277777777778,512,2325,1813,1017.250000000000000,759.789896945201576,4069.000000000000000,3,512,2,50.0000000,720,1,25.0000000,512,2325
2557,4.000000000000000,0.000277777777778,354,3125,2771,1626.500000000000000,1017.203150801254651,6506.000000000000000,4,354,1,25.0000000,354,1,25.0000000,1161,3125
2558,2.000000000000000,0.000138888888889,249,1682,1433,965.500000000000000,716.500000000000000,1931.000000000000000,2,249,1,50.0000000,249,1,50.0000000,249,1682
2559,4.000000000000000,0.000277777777778,211,2490,2279,1596.250000000000000,926.356134270184498,6385.000000000000000,4,211,1,25.0000000,211,1,25.0000000,1297,2490
2560,4.000000000000000,0.000277777777778,2016,8959,6943,4692.500000000000000,2698.948174752527393,18770.000000000000000,4,2016,1,25.0000000,2016,1,25.0000000,2778,8959
2561,3.000000000000000,0.000208333333333,430,930,500,636.333333333333258,213.260925211868624,1909.000000000000000,3,430,1,33.3333015,430,1,33.3333015,549,930
2562,4.000000000000000,0.000277777777778,321,798,477,575.500000000000000,190.911628771010186,2302.000000000000000,4,321,1,25.0000000,321,1,25.0000000,467,798
2563,3.000000000000000,0.000208333333333,321,716,395,501.333333333333314,163.075306394179620,1504.000000000000000,3,321,1,33.3333015,321,1,33.3333015,467,716
2564,3.000000000000000,0.000208333333333,206,1239,1033,803.666666666666629,437.063178753623959,2411.000000000000000,3,206,1,33.3333015,206,1,33.3333015,966,1239
2565,4.000000000000000,0.000277777777778,221,899,678,523.750000000000000,300.249375519750231,2095.000000000000000,4,221,1,25.0000000,221,1,25.0000000,237,899
2566,2.000000000000000,0.000138888888889,746,873,127,809.500000000000000,63.500000000000000,1619.000000000000000,2,746,1,50.0000000,746,1,50.0000000,746,873
2567,4.000000000000000,0.000277777777778,66,365,299,188.500000000000000,119.374410993311287,754.000000000000000,4,66,1,25.0000000,66,1,25.0000000,93,365
2568,4.000000000000000,0.000277777777778,1105,2194,1089,1775.250000000000000,405.790201335616302,7101.000000000000000,4,1105,1,25.0000000,1105,1,25.0000000,1866,2194
2569,3.000000000000000,0.000208333333333,674,1094,420,936.000000000000000,186.569022080301437,2808.000000000000000,3,674,1,33.3333015,674,1,33.3333015,1040,1094
2570,4.000000000000000,0.000277777777778,9,1745,1736,517.750000000000000,712.298173169073948,2071.000000000000000,4,9,1,25.0000000,9,1,25.0000000,102,1745
2571,4.000000000000000,0.000277777777778,295,1309,1014,684.500000000000000,393.063290069169398,2738.000000000000000,4,295,1,25.0000000,295,1,25.0000000,411,1309
2572,4.000000000000000,0.000277777777778,159,3115,2956,1025.500000000000000,1210.881806783800130,4102.000000000000000,4,159,1,25.0000000,159,1,25.0000000,403,3115
2573,4.000000000000000,0.000277777777778,19,1753,1734,528.500000000000000,716.751525983726083,2114.000000000000000,4,19,1,25.0000000,19,1,25.0000000,29,1753
2574,4.000000000000000,0.000277777777778,729,1365,636,1018.750000000000000,269.978124113788169,4075.000000000000000,4,729,1,25.0000000,729,1,25.0000000,783,1365
2575,5.000000000000000,0.000347222222222,546,1045,499,835.600000000000023,165.592995020924718,4178.000000000000000,5,546,1,20.0000000,546,1,20.0000000,846,1045
2576,4.000000000000000,0.000277777777778,995,2807,1812,1783.250000000000000,651.639614741154332,7133.000000000000000,4,995,1,25.0000000,995,1,25.0000000,1639,2807
2577,4.000000000000000,0.000277777777778,816,1119,303,937.000000000000000,111.586289480383755,3748.000000000000000,4,816,1,25.0000000,816,1,25.0000000,897,1119
2578,3.000000000000000,0.000208333333333,816,4054,3238,1978.333333333333258,1471.234024740984296,5935.000000000000000,3,816,1,33.3333015,816,1,33.3333015,1065,4054
2579,5.000000000000000,0.000347222222222,258,901,643,541.399999999999977,234.091947747033771,2707.000000000000000,5,258,1,20.0000000,258,1,20.0000000,616,901
2580,4.000000000000000,0.000277777777778,657,2830,2173,1427.250000000000000,872.105319041226835,5709.000000000000000,4,657,1,25.0000000,657,1,25.0000000,736,2830
2581,4.000000000000000,0.000277777777778,27,265,238,96.000000000000000,98.135110944044897,384.000000000000000,4,27,1,25.0000000,27,1,25.0000000,36,265
2582,4.000000000000000,0.000277777777778,802,1391,589,1215.000000000000000,239.955204152775167,4860.000000000000000,4,802,1,25.0000000,802,1,25.0000000,1315,1391
2583,4.000000000000000,0.000277777777778,795,2638,1843,1440.500000000000000,708.087035610736166,5762.000000000000000,4,795,1,25.0000000,795,1,25.0000000,1129,2638
2584,4.000000000000000,0.000277777777778,1228,1653,425,1364.250000000000000,169.216392527438074,5457.000000000000000,4,1228,1,25.0000000,1228,1,25.0000000,1266,1653
2585,4.000000000000000,0.000277777777778,4,1039,1035,263.500000000000000,447.736808850914088,1054.000000000000000,3,4,2,50.0000000,7,1,25.0000000,4,1039
2586,5.000000000000000,0.000347222222222,161,783,622,448.399999999999977,242.463688002966734,2242.000000000000000,5,161,1,20.0000000,161,1,20.0000000,458,783
2587,4.000000000000000,0.000277777777778,270,2533,2263,1140.250000000000000,848.409209933508464,4561.000000000000000,4,270,1,25.0000000,270,1,25.0000000,728,2533
2588,4.000000000000000,0.000277777777778,1159,2502,1343,1776.500000000000000,481.871611531536473,7106.000000000000000,4,1159,1,25.0000000,1159,1,25.0000000,1635,2502
2589,4.000000000000000,0.000277777777778,1159,2502,1343,1776.500000000000000,481.871611531536473,7106.000000000000000,4,1159,1,25.0000000,1159,1,25.0000000,1635,2502
2590,4.000000000000000,0.000277777777778,1159,2502,1343,1776.500000000000000,481.871611531536473,7106.000000000000000,4,1159,1,25.0000000,1159,1,25.0000000,1635,2502
2591,4.000000000000000,0.000277777777778,2,246,244,119.250000000000014,116.489001626763041,477.000000000000000,4,2,1,25.0000000,2,1,25.0000000,4,246
2592,4.000000000000000,0.000277777777778,615,1231,616,987.750000000000000,258.891265785464441,3951.000000000000000,4,615,1,25.0000000,615,1,25.0000000,877,1231
2593,3.000000000000000,0.000208333333333,877,1231,354,1112.000000000000000,166.174606965083569,3336.000000000000000,3,877,1,33.3333015,877,1,33.3333015,1228,1231
2594,4.000000000000000,0.000277777777778,156,938,782,510.750000000000000,279.624189761901675,2043.000000000000000,4,156,1,25.0000000,156,1,25.0000000,445,938
2595,5.000000000000000,0.000347222222222,1187,3500,2313,1893.400000000000091,873.771732204698765,9467.000000000000000,5,1187,1,20.0000000,1187,1,20.0000000,1332,3500
2596,4.000000000000000,0.000277777777778,211,2490,2279,1596.250000000000000,926.356134270184498,6385.000000000000000,4,211,1,25.0000000,211,1,25.0000000,1297,2490
2597,3.000000000000000,0.000208333333333,292,677,385,480.000000000000000,157.304375866237962,1440.000000000000000,3,292,1,33.3333015,292,1,33.3333015,471,677
2598,3.000000000000000,0.000208333333333,229,471,242,330.666666666666629,102.509620144756283,992.000000000000000,3,229,1,33.3333015,229,1,33.3333015,292,471
2599,4.000000000000000,0.000277777777778,295,2561,2266,1524.250000000000000,1007.640653953580795,6097.000000000000000,4,295,1,25.0000000,295,1,25.0000000,767,2561
2600,4.000000000000000,0.000277777777778,295,2561,2266,1524.250000000000000,1007.640653953580795,6097.000000000000000,4,295,1,25.0000000,295,1,25.0000000,767,2561
2601,4.000000000000000,0.000277777777778,295,2561,2266,1524.250000000000000,1007.640653953580795,6097.000000000000000,4,295,1,25.0000000,295,1,25.0000000,767,2561
2602,5.000000000000000,0.000347222222222,965,2319,1354,1681.400000000000091,553.680991185357584,8407.000000000000000,5,965,1,20.0000000,965,1,20.0000000,1690,2319
2603,4.000000000000000,0.000277777777778,785,2647,1862,1296.250000000000000,782.873992095790641,5185.000000000000000,4,785,1,25.0000000,785,1,25.0000000,795,2647
2604,4.000000000000000,0.000277777777778,1171,1375,204,1272.250000000000000,84.962859532857053,5089.000000000000000,4,1171,1,25.0000000,1171,1,25.0000000,1208,1375
2605,4.000000000000000,0.000277777777778,545,3283,2738,1617.750000000000000,1027.482694501469496,6471.000000000000000,4,545,1,25.0000000,545,1,25.0000000,1073,3283
2606,3.000000000000000,0.000208333333333,122,1370,1248,694.666666666666629,514.639895676794822,2084.000000000000000,3,122,1,33.3333015,122,1,33.3333015,592,1370
2607,4.000000000000000,0.000277777777778,906,2664,1758,1625.750000000000000,643.143986600201401,6503.000000000000000,4,906,1,25.0000000,906,1,25.0000000,1404,2664
2608,4.000000000000000,0.000277777777778,57,1224,1167,429.750000000000000,475.769048488865053,1719.000000000000000,4,57,1,25.0000000,57,1,25.0000000,66,1224
2609,3.000000000000000,0.000208333333333,25,168,143,94.000000000000000,58.486465670842740,282.000000000000000,3,25,1,33.3333015,25,1,33.3333015,89,168
2610,4.000000000000000,0.000277777777778,25,168,143,111.250000000000000,58.806355948995851,445.000000000000000,4,25,1,25.0000000,25,1,25.0000000,89,168
2611,3.000000000000000,0.000208333333333,28,11535,11507,5481.000000000000000,4716.896083937685034,16443.000000000000000,3,28,1,33.3333015,28,1,33.3333015,4880,11535
2612,3.000000000000000,0.000208333333333,28,11535,11507,5481.000000000000000,4716.896083937685034,16443.000000000000000,3,28,1,33.3333015,28,1,33.3333015,4880,11535
2613,4.000000000000000,0.000277777777778,719,2711,1992,1233.000000000000000,853.424864882667976,4932.000000000000000,4,719,1,25.0000000,719,1,25.0000000,749,2711
2614,4.000000000000000,0.000277777777778,553,997,444,756.500000000000000,160.331687448239592,3026.000000000000000,4,553,1,25.0000000,553,1,25.0000000,700,997
2615,4.000000000000000,0.000277777777778,24,728,704,336.000000000000000,298.858662246888855,1344.000000000000000,4,24,1,25.0000000,24,1,25.0000000,69,728
2616,5.000000000000000,0.000347222222222,561,5704,5143,2313.000000000000000,1789.101785813205197,11565.000000000000000,5,561,1,20.0000000,561,1,20.0000000,2042,5704
2617,5.000000000000000,0.000347222222222,77,1110,1033,460.399999999999977,351.100897179144226,2302.000000000000000,5,77,1,20.0000000,77,1,20.0000000,371,1110
2618,4.000000000000000,0.000277777777778,124,1395,1271,769.250000000000000,506.759990034730322,3077.000000000000000,4,124,1,25.0000000,124,1,25.0000000,448,1395
2619,3.000000000000000,0.000208333333333,124,2834,2710,1451.000000000000000,1107.061275028020646,4353.000000000000000,3,124,1,33.3333015,124,1,33.3333015,1395,2834
2620,4.000000000000000,0.000277777777778,124,1395,1271,769.250000000000000,506.759990034730322,3077.000000000000000,4,124,1,25.0000000,124,1,25.0000000,448,1395
2621,4.000000000000000,0.000277777777778,326,2111,1785,960.000000000000000,706.790987492059116,3840.000000000000000,4,326,1,25.0000000,326,1,25.0000000,439,2111
2622,4.000000000000000,0.000277777777778,35,2228,2193,1153.750000000000000,980.409703899344322,4615.000000000000000,4,35,1,25.0000000,35,1,25.0000000,328,2228
2623,5.000000000000000,0.000347222222222,91,906,815,574.200000000000045,282.305791651535174,2871.000000000000000,5,91,1,20.0000000,91,1,20.0000000,543,906
2624,4.000000000000000,0.000277777777778,894,977,83,945.000000000000000,34.705907278156552,3780.000000000000000,3,977,2,50.0000000,894,1,25.0000000,932,977
2625,5.000000000000000,0.000347222222222,2400,5697,3297,3649.199999999999818,1145.709457061431294,18246.000000000000000,5,2400,1,20.0000000,2400,1,20.0000000,3561,5697
2626,4.000000000000000,0.000277777777778,184,2656,2472,949.500000000000000,992.739014041454880,3798.000000000000000,4,184,1,25.0000000,184,1,25.0000000,454,2656
2627,6.000000000000000,0.000416666666667,568,6306,5738,2541.666666666666970,2384.702683541260285,15250.000000000000000,6,568,1,16.6667004,568,1,16.6667004,1103,5452
2628,4.000000000000000,0.000277777777778,20,804,784,321.250000000000000,326.808334502044204,1285.000000000000000,4,20,1,25.0000000,20,1,25.0000000,22,804
2629,4.000000000000000,0.000277777777778,866,1529,663,1298.250000000000000,255.165020134030158,5193.000000000000000,4,866,1,25.0000000,866,1,25.0000000,1394,1529
2630,4.000000000000000,0.000277777777778,726,2270,1544,1559.250000000000000,563.785143028796028,6237.000000000000000,4,726,1,25.0000000,726,1,25.0000000,1441,2270
2631,3.000000000000000,0.000208333333333,140,2165,2025,964.000000000000000,868.620745780343441,2892.000000000000000,3,140,1,33.3333015,140,1,33.3333015,587,2165
2632,5.000000000000000,0.000347222222222,234,2981,2747,1128.000000000000000,988.155453357415809,5640.000000000000000,5,234,1,20.0000000,234,1,20.0000000,727,2981
2633,4.000000000000000,0.000277777777778,47,1463,1416,689.250000000000000,646.289553915270972,2757.000000000000000,4,47,1,25.0000000,47,1,25.0000000,53,1463
2634,2.000000000000000,0.000138888888889,908,4824,3916,2866.000000000000000,1958.000000000000000,5732.000000000000000,2,908,1,50.0000000,908,1,50.0000000,908,4824
2635,4.000000000000000,0.000277777777778,446,1276,830,938.000000000000000,352.201646787745744,3752.000000000000000,4,446,1,25.0000000,446,1,25.0000000,762,1276
2636,4.000000000000000,0.000277777777778,430,2711,2281,1871.250000000000000,860.876697036224755,7485.000000000000000,4,430,1,25.0000000,430,1,25.0000000,2148,2711
2637,4.000000000000000,0.000277777777778,300,1167,867,866.500000000000000,354.511283318316941,3466.000000000000000,3,1167,2,50.0000000,300,1,25.0000000,832,1167
2638,4.000000000000000,0.000277777777778,487,1826,1339,1033.000000000000000,543.119231845089416,4132.000000000000000,4,487,1,25.0000000,487,1,25.0000000,576,1826
2639,4.000000000000000,0.000277777777778,118,670,552,505.750000000000000,227.491071253357120,2023.000000000000000,4,118,1,25.0000000,118,1,25.0000000,569,670
2640,4.000000000000000,0.000277777777778,721,2428,1707,1183.750000000000000,718.974747470312764,4735.000000000000000,4,721,1,25.0000000,721,1,25.0000000,789,2428
2641,4.000000000000000,0.000277777777778,211,1144,933,661.750000000000000,406.001462435789733,2647.000000000000000,4,211,1,25.0000000,211,1,25.0000000,312,1144
2642,4.000000000000000,0.000277777777778,14,1112,1098,402.249999999999943,437.514785464445765,1609.000000000000000,4,14,1,25.0000000,14,1,25.0000000,69,1112
2643,4.000000000000000,0.000277777777778,122,2297,2175,1397.000000000000000,835.081133782819961,5588.000000000000000,4,122,1,25.0000000,122,1,25.0000000,1208,2297
2644,4.000000000000000,0.000277777777778,19,2249,2230,591.500000000000000,957.062563263238303,2366.000000000000000,4,19,1,25.0000000,19,1,25.0000000,39,2249
2645,4.000000000000000,0.000277777777778,654,748,94,694.500000000000000,38.874799034850319,2778.000000000000000,4,654,1,25.0000000,654,1,25.0000000,661,748
2646,5.000000000000000,0.000347222222222,654,858,204,727.200000000000045,74.068616836012268,3636.000000000000000,5,654,1,20.0000000,654,1,20.0000000,715,858
2647,4.000000000000000,0.000277777777778,654,858,204,722.000000000000000,81.990853148384801,2888.000000000000000,4,654,1,25.0000000,654,1,25.0000000,661,858
2648,4.000000000000000,0.000277777777778,19,3426,3407,925.750000000000000,1444.309934709306162,3703.000000000000000,4,19,1,25.0000000,19,1,25.0000000,106,3426
2649,4.000000000000000,0.000277777777778,227,3649,3422,1252.750000000000000,1404.219066776975524,5011.000000000000000,4,227,1,25.0000000,227,1,25.0000000,290,3649
2650,4.000000000000000,0.000277777777778,543,2210,1667,1275.750000000000000,703.419993673765248,5103.000000000000000,4,543,1,25.0000000,543,1,25.0000000,651,2210
2651,4.000000000000000,0.000277777777778,139,1631,1492,928.750000000000000,670.256061143799002,3715.000000000000000,4,139,1,25.0000000,139,1,25.0000000,391,1631
2652,4.000000000000000,0.000277777777778,542,977,435,734.500000000000000,184.413258742423409,2938.000000000000000,4,542,1,25.0000000,542,1,25.0000000,570,977
2653,4.000000000000000,0.000277777777778,542,964,422,731.250000000000000,180.176822871311600,2925.000000000000000,4,542,1,25.0000000,542,1,25.0000000,570,964
2654,4.000000000000000,0.000277777777778,322,964,642,676.250000000000000,249.712209353087076,2705.000000000000000,4,322,1,25.0000000,322,1,25.0000000,570,964
2655,4.000000000000000,0.000277777777778,682,7771,7089,2751.750000000000000,2916.763306732309957,11007.000000000000000,4,682,1,25.0000000,682,1,25.0000000,958,7771
2656,3.000000000000000,0.000208333333333,636,3356,2720,1663.666666666666515,1205.801623632824203,4991.000000000000000,3,636,1,33.3333015,636,1,33.3333015,999,3356
2657,4.000000000000000,0.000277777777778,110,1943,1833,945.750000000000000,827.639527511826827,3783.000000000000000,4,110,1,25.0000000,110,1,25.0000000,146,1943
2658,4.000000000000000,0.000277777777778,43,1698,1655,663.000000000000000,634.538808899818150,2652.000000000000000,4,43,1,25.0000000,43,1,25.0000000,270,1698
2659,4.000000000000000,0.000277777777778,43,1698,1655,663.000000000000000,634.538808899818150,2652.000000000000000,4,43,1,25.0000000,43,1,25.0000000,270,1698
2660,4.000000000000000,0.000277777777778,43,1698,1655,663.000000000000000,634.538808899818150,2652.000000000000000,4,43,1,25.0000000,43,1,25.0000000,270,1698
2661,4.000000000000000,0.000277777777778,132,3636,3504,1153.750000000000000,1442.044793860440450,4615.000000000000000,4,132,1,25.0000000,132,1,25.0000000,272,3636
2662,3.000000000000000,0.000208333333333,1466,2774,1308,2022.000000000000000,551.681067284350434,6066.000000000000000,3,1466,1,33.3333015,1466,1,33.3333015,1826,2774
2663,4.000000000000000,0.000277777777778,689,1208,519,957.000000000000000,201.899727587731036,3828.000000000000000,4,689,1,25.0000000,689,1,25.0000000,847,1208
2664,4.000000000000000,0.000277777777778,349,3138,2789,1891.000000000000000,1082.579096417439587,7564.000000000000000,4,349,1,25.0000000,349,1,25.0000000,1442,3138
2665,4.000000000000000,0.000277777777778,877,1383,506,1212.750000000000000,202.973366479447236,4851.000000000000000,4,877,1,25.0000000,877,1,25.0000000,1227,1383
2666,4.000000000000000,0.000277777777778,877,1364,487,1105.750000000000000,197.766750238759812,4423.000000000000000,4,877,1,25.0000000,877,1,25.0000000,955,1364
2667,4.000000000000000,0.000277777777778,598,1076,478,801.750000000000000,173.977548838923468,3207.000000000000000,4,598,1,25.0000000,598,1,25.0000000,736,1076
2668,4.000000000000000,0.000277777777778,47,640,593,397.000000000000000,244.332764892471999,1588.000000000000000,4,47,1,25.0000000,47,1,25.0000000,290,640
2669,4.000000000000000,0.000277777777778,133,1227,1094,697.250000000000000,492.074371919530051,2789.000000000000000,4,133,1,25.0000000,133,1,25.0000000,285,1227
2670,5.000000000000000,0.000347222222222,133,1227,1094,703.799999999999955,440.319611191688807,3519.000000000000000,5,133,1,20.0000000,133,1,20.0000000,730,1227
2671,4.000000000000000,0.000277777777778,115,1270,1155,518.000000000000000,458.000545851203128,2072.000000000000000,4,115,1,25.0000000,115,1,25.0000000,185,1270
2672,4.000000000000000,0.000277777777778,167,1892,1725,682.000000000000000,705.737557453193745,2728.000000000000000,4,167,1,25.0000000,167,1,25.0000000,231,1892
2673,4.000000000000000,0.000277777777778,561,790,229,683.000000000000000,101.747235834689874,2732.000000000000000,4,561,1,25.0000000,561,1,25.0000000,604,790
2674,4.000000000000000,0.000277777777778,58,1626,1568,679.000000000000000,619.027463041826650,2716.000000000000000,4,58,1,25.0000000,58,1,25.0000000,202,1626
2675,4.000000000000000,0.000277777777778,468,2734,2266,1773.000000000000000,829.561932588519994,7092.000000000000000,4,468,1,25.0000000,468,1,25.0000000,1762,2734
2676,5.000000000000000,0.000347222222222,468,2734,2266,1403.199999999999818,879.522916131239867,7016.000000000000000,5,468,1,20.0000000,468,1,20.0000000,1029,2734
2677,4.000000000000000,0.000277777777778,31,528,497,167.750000000000000,208.587361793566004,671.000000000000000,4,31,1,25.0000000,31,1,25.0000000,39,528
2678,4.000000000000000,0.000277777777778,515,1176,661,836.750000000000000,258.271538308037350,3347.000000000000000,4,515,1,25.0000000,515,1,25.0000000,673,1176
2679,5.000000000000000,0.000347222222222,57,1613,1556,642.399999999999977,549.330355978986404,3212.000000000000000,5,57,1,20.0000000,57,1,20.0000000,558,1613
2680,4.000000000000000,0.000277777777778,34,182,148,112.750000000000000,52.599310831987140,451.000000000000000,4,34,1,25.0000000,34,1,25.0000000,114,182
2681,5.000000000000000,0.000347222222222,34,182,148,98.400000000000006,55.109345849864702,492.000000000000000,5,34,1,20.0000000,34,1,20.0000000,114,182
2682,4.000000000000000,0.000277777777778,243,530,287,389.250000000000000,122.113420638355720,1557.000000000000000,4,243,1,25.0000000,243,1,25.0000000,296,530
2683,4.000000000000000,0.000277777777778,830,1425,595,1065.500000000000000,239.610621634350792,4262.000000000000000,4,830,1,25.0000000,830,1,25.0000000,867,1425
2684,4.000000000000000,0.000277777777778,830,1425,595,1065.500000000000000,239.610621634350792,4262.000000000000000,4,830,1,25.0000000,830,1,25.0000000,867,1425
2685,5.000000000000000,0.000347222222222,626,1425,799,940.399999999999977,265.120802654186321,4702.000000000000000,5,626,1,20.0000000,626,1,20.0000000,867,1425
2686,3.000000000000000,0.000208333333333,216,1106,890,668.333333333333371,363.488957496953731,2005.000000000000000,3,216,1,33.3333015,216,1,33.3333015,683,1106
2687,3.000000000000000,0.000208333333333,386,2512,2126,1291.666666666666742,896.002356147695878,3875.000000000000000,3,386,1,33.3333015,386,1,33.3333015,977,2512
2688,4.000000000000000,0.000277777777778,636,2372,1736,1198.000000000000000,696.519920748861296,4792.000000000000000,4,636,1,25.0000000,636,1,25.0000000,720,2372
2689,4.000000000000000,0.000277777777778,636,2372,1736,1198.000000000000000,696.519920748861296,4792.000000000000000,4,636,1,25.0000000,636,1,25.0000000,720,2372
2690,5.000000000000000,0.000347222222222,618,2428,1810,1153.799999999999955,668.515788893575746,5769.000000000000000,5,618,1,20.0000000,618,1,20.0000000,789,2428
2691,4.000000000000000,0.000277777777778,315,1243,928,809.500000000000000,333.314791150947883,3238.000000000000000,4,315,1,25.0000000,315,1,25.0000000,769,1243
2692,4.000000000000000,0.000277777777778,273,994,721,798.250000000000000,303.517194735323017,3193.000000000000000,3,963,2,50.0000000,273,1,25.0000000,963,994
2693,4.000000000000000,0.000277777777778,463,1411,948,873.500000000000000,345.905695240769319,3494.000000000000000,4,463,1,25.0000000,463,1,25.0000000,729,1411
2694,4.000000000000000,0.000277777777778,585,5895,5310,2858.000000000000000,2014.357589903043845,11432.000000000000000,4,585,1,25.0000000,585,1,25.0000000,1596,5895
2695,5.000000000000000,0.000347222222222,164,1219,1055,623.200000000000045,350.679568837421755,3116.000000000000000,5,164,1,20.0000000,164,1,20.0000000,637,1219
2696,4.000000000000000,0.000277777777778,874,2351,1477,1315.500000000000000,604.773718013605503,5262.000000000000000,4,874,1,25.0000000,874,1,25.0000000,920,2351
2697,4.000000000000000,0.000277777777778,158,944,786,507.750000000000000,282.552981757404211,2031.000000000000000,4,158,1,25.0000000,158,1,25.0000000,426,944
2698,4.000000000000000,0.000277777777778,403,3115,2712,1826.500000000000000,1231.618751887125200,7306.000000000000000,4,403,1,25.0000000,403,1,25.0000000,805,3115
2699,4.000000000000000,0.000277777777778,403,3115,2712,1826.500000000000000,1231.618751887125200,7306.000000000000000,4,403,1,25.0000000,403,1,25.0000000,805,3115
2700,3.000000000000000,0.000208333333333,945,1805,860,1425.333333333333258,358.236731164680464,4276.000000000000000,3,945,1,33.3333015,945,1,33.3333015,1526,1805
2701,4.000000000000000,0.000277777777778,831,1526,695,1135.250000000000000,270.283531684784691,4541.000000000000000,4,831,1,25.0000000,831,1,25.0000000,945,1526
2702,4.000000000000000,0.000277777777778,93,1353,1260,506.250000000000000,507.928821292905184,2025.000000000000000,4,93,1,25.0000000,93,1,25.0000000,131,1353
2703,4.000000000000000,0.000277777777778,93,1353,1260,506.250000000000000,507.928821292905184,2025.000000000000000,4,93,1,25.0000000,93,1,25.0000000,131,1353
2704,4.000000000000000,0.000277777777778,753,8479,7726,3982.749999999999545,2840.111122385882936,15931.000000000000000,4,753,1,25.0000000,753,1,25.0000000,2711,8479
2705,4.000000000000000,0.000277777777778,753,8479,7726,3982.749999999999545,2840.111122385882936,15931.000000000000000,4,753,1,25.0000000,753,1,25.0000000,2711,8479
2706,4.000000000000000,0.000277777777778,830,3908,3078,1823.250000000000000,1242.106954935846034,7293.000000000000000,4,830,1,25.0000000,830,1,25.0000000,929,3908
2707,4.000000000000000,0.000277777777778,794,4565,3771,1821.250000000000000,1585.721503764138333,7285.000000000000000,4,794,1,25.0000000,794,1,25.0000000,936,4565
2708,4.000000000000000,0.000277777777778,67,233,166,133.000000000000000,64.015623093116886,532.000000000000000,4,67,1,25.0000000,67,1,25.0000000,89,233
2709,3.000000000000000,0.000208333333333,726,2100,1374,1588.000000000000000,613.103580155914642,4764.000000000000000,3,726,1,33.3333015,726,1,33.3333015,1938,2100
2710,4.000000000000000,0.000277777777778,308,900,592,588.250000000000000,215.411669832439685,2353.000000000000000,4,308,1,25.0000000,308,1,25.0000000,504,900
2711,4.000000000000000,0.000277777777778,606,3327,2721,1386.500000000000000,1129.861164037422895,5546.000000000000000,4,606,1,25.0000000,606,1,25.0000000,635,3327
2712,3.000000000000000,0.000208333333333,673,4123,3450,1938.666666666666970,1551.039722967217358,5816.000000000000000,3,673,1,33.3333015,673,1,33.3333015,1020,4123
2713,5.000000000000000,0.000347222222222,35,1842,1807,849.799999999999955,607.901768380385647,4249.000000000000000,5,35,1,20.0000000,35,1,20.0000000,735,1842
2714,4.000000000000000,0.000277777777778,54,2371,2317,915.000000000000000,900.872077489362482,3660.000000000000000,4,54,1,25.0000000,54,1,25.0000000,295,2371
2715,3.000000000000000,0.000208333333333,295,5276,4981,2170.333333333333030,2211.768573386967546,6511.000000000000000,3,295,1,33.3333015,295,1,33.3333015,940,5276
2716,4.000000000000000,0.000277777777778,318,1753,1435,1022.500000000000000,519.591426026257636,4090.000000000000000,4,318,1,25.0000000,318,1,25.0000000,852,1753
2717,4.000000000000000,0.000277777777778,690,1476,786,1153.750000000000000,293.208436952281488,4615.000000000000000,4,690,1,25.0000000,690,1,25.0000000,1138,1476
2718,3.000000000000000,0.000208333333333,2521,4612,2091,3626.666666666666515,857.877354611692454,10880.000000000000000,3,2521,1,33.3333015,2521,1,33.3333015,3747,4612
2719,4.000000000000000,0.000277777777778,51,1090,1039,527.000000000000000,472.390198882237655,2108.000000000000000,4,51,1,25.0000000,51,1,25.0000000,68,1090
2720,3.000000000000000,0.000208333333333,205,2996,2791,1963.666666666666515,1249.824076509258930,5891.000000000000000,3,205,1,33.3333015,205,1,33.3333015,2690,2996
2721,6.000000000000000,0.000416666666667,670,3258,2588,1503.666666666666742,904.424064744458747,9022.000000000000000,6,670,1,16.6667004,670,1,16.6667004,928,1844
2722,4.000000000000000,0.000277777777778,553,997,444,756.500000000000000,160.331687448239592,3026.000000000000000,4,553,1,25.0000000,553,1,25.0000000,700,997
2723,5.000000000000000,0.000347222222222,530,3812,3282,1768.400000000000091,1101.201997818747031,8842.000000000000000,5,530,1,20.0000000,530,1,20.0000000,1617,3812
2724,4.000000000000000,0.000277777777778,587,1680,1093,942.249999999999886,438.771224557855476,3769.000000000000000,4,587,1,25.0000000,587,1,25.0000000,636,1680
2725,4.000000000000000,0.000277777777778,207,6812,6605,3627.249999999999545,2437.310543919260454,14509.000000000000000,4,207,1,25.0000000,207,1,25.0000000,2772,6812
2726,4.000000000000000,0.000277777777778,79,738,659,384.250000000000000,234.558494836575903,1537.000000000000000,4,79,1,25.0000000,79,1,25.0000000,343,738
2727,4.000000000000000,0.000277777777778,137,668,531,373.500000000000000,238.738874086312109,1494.000000000000000,4,137,1,25.0000000,137,1,25.0000000,140,668
2728,4.000000000000000,0.000277777777778,137,668,531,373.500000000000000,238.738874086312109,1494.000000000000000,4,137,1,25.0000000,137,1,25.0000000,140,668
2729,4.000000000000000,0.000277777777778,146,656,510,499.250000000000000,207.958379249310354,1997.000000000000000,4,146,1,25.0000000,146,1,25.0000000,551,656
2730,4.000000000000000,0.000277777777778,146,656,510,499.250000000000000,207.958379249310354,1997.000000000000000,4,146,1,25.0000000,146,1,25.0000000,551,656
2731,4.000000000000000,0.000277777777778,636,3356,2720,1775.250000000000000,987.112803837535125,7101.000000000000000,4,636,1,25.0000000,636,1,25.0000000,1513,3356
2732,4.000000000000000,0.000277777777778,31,2216,2185,931.500000000000000,869.429266818181077,3726.000000000000000,4,31,1,25.0000000,31,1,25.0000000,245,2216
2733,4.000000000000000,0.000277777777778,725,2264,1539,1115.750000000000000,662.960924564940001,4463.000000000000000,4,725,1,25.0000000,725,1,25.0000000,736,2264
2734,3.000000000000000,0.000208333333333,43,1104,1061,489.666666666666629,449.083758582095982,1469.000000000000000,3,43,1,33.3333015,43,1,33.3333015,322,1104
2735,4.000000000000000,0.000277777777778,374,765,391,636.250000000000000,156.357562976659352,2545.000000000000000,4,374,1,25.0000000,374,1,25.0000000,661,765
2736,4.000000000000000,0.000277777777778,780,1207,427,999.750000000000000,152.481761204414227,3999.000000000000000,4,780,1,25.0000000,780,1,25.0000000,977,1207
2737,4.000000000000000,0.000277777777778,445,3754,3309,1630.500000000000000,1326.228581353908339,6522.000000000000000,4,445,1,25.0000000,445,1,25.0000000,578,3754
2738,4.000000000000000,0.000277777777778,578,3754,3176,2043.750000000000000,1136.394820253946818,8175.000000000000000,4,578,1,25.0000000,578,1,25.0000000,1745,3754
2739,4.000000000000000,0.000277777777778,677,936,259,764.000000000000000,102.944159620640932,3056.000000000000000,4,677,1,25.0000000,677,1,25.0000000,693,936
2740,4.000000000000000,0.000277777777778,656,1515,859,1007.500000000000000,341.829270250515606,4030.000000000000000,4,656,1,25.0000000,656,1,25.0000000,737,1515
2741,4.000000000000000,0.000277777777778,181,2829,2648,1508.750000000000000,1062.834976607375211,6035.000000000000000,4,181,1,25.0000000,181,1,25.0000000,801,2829
2742,4.000000000000000,0.000277777777778,181,2829,2648,1508.750000000000000,1062.834976607375211,6035.000000000000000,4,181,1,25.0000000,181,1,25.0000000,801,2829
2743,3.000000000000000,0.000208333333333,283,1483,1200,785.000000000000000,509.124739135705340,2355.000000000000000,3,283,1,33.3333015,283,1,33.3333015,589,1483
2744,4.000000000000000,0.000277777777778,94,852,758,300.250000000000000,319.355894731880596,1201.000000000000000,4,94,1,25.0000000,94,1,25.0000000,102,852
2745,4.000000000000000,0.000277777777778,545,3283,2738,1617.750000000000000,1027.482694501469496,6471.000000000000000,4,545,1,25.0000000,545,1,25.0000000,1073,3283
2746,4.000000000000000,0.000277777777778,452,807,355,650.750000000000000,131.564385378414642,2603.000000000000000,4,452,1,25.0000000,452,1,25.0000000,625,807
2747,4.000000000000000,0.000277777777778,74,2134,2060,832.750000000000000,792.538129997541546,3331.000000000000000,4,74,1,25.0000000,74,1,25.0000000,342,2134
2748,4.000000000000000,0.000277777777778,412,640,228,516.250000000000000,97.566323595798153,2065.000000000000000,4,412,1,25.0000000,412,1,25.0000000,430,640
2749,5.000000000000000,0.000347222222222,725,1763,1038,1246.200000000000045,415.762143538826820,6231.000000000000000,5,725,1,20.0000000,725,1,20.0000000,1122,1763
2750,4.000000000000000,0.000277777777778,163,688,525,436.250000000000000,211.644011254748250,1745.000000000000000,4,163,1,25.0000000,163,1,25.0000000,304,688
2751,4.000000000000000,0.000277777777778,559,5874,5315,1937.500000000000000,2273.648884502618330,7750.000000000000000,4,559,1,25.0000000,559,1,25.0000000,588,5874
2752,4.000000000000000,0.000277777777778,681,1052,371,818.750000000000000,142.287341320301579,3275.000000000000000,4,681,1,25.0000000,681,1,25.0000000,732,1052
2753,4.000000000000000,0.000277777777778,255,2533,2278,1336.000000000000000,921.870381344362272,5344.000000000000000,4,255,1,25.0000000,255,1,25.0000000,649,2533
2754,4.000000000000000,0.000277777777778,192,458,266,379.500000000000000,108.695676086953895,1518.000000000000000,3,434,2,50.0000000,192,1,25.0000000,434,458
2755,4.000000000000000,0.000277777777778,126,849,723,462.500000000000000,266.301051443662175,1850.000000000000000,4,126,1,25.0000000,126,1,25.0000000,338,849
2756,4.000000000000000,0.000277777777778,286,1860,1574,1000.750000000000000,636.066574738839790,4003.000000000000000,4,286,1,25.0000000,286,1,25.0000000,505,1860
2757,4.000000000000000,0.000277777777778,137,826,689,489.500000000000000,251.116009047611271,1958.000000000000000,4,137,1,25.0000000,137,1,25.0000000,412,826
2758,4.000000000000000,0.000277777777778,137,826,689,510.750000000000000,261.510396542852561,2043.000000000000000,4,137,1,25.0000000,137,1,25.0000000,412,826
2759,5.000000000000000,0.000347222222222,133,826,693,418.199999999999989,266.049168388100782,2091.000000000000000,5,133,1,20.0000000,133,1,20.0000000,412,826
2760,4.000000000000000,0.000277777777778,137,826,689,489.500000000000000,251.116009047611271,1958.000000000000000,4,137,1,25.0000000,137,1,25.0000000,412,826
2761,3.000000000000000,0.000208333333333,137,668,531,405.666666666666686,216.826095190490292,1217.000000000000000,3,137,1,33.3333015,137,1,33.3333015,412,668
2762,5.000000000000000,0.000347222222222,1904,5420,3516,3933.400000000000091,1327.748409903020956,19667.000000000000000,5,1904,1,20.0000000,1904,1,20.0000000,3494,5420
2763,3.000000000000000,0.000208333333333,1029,2408,1379,1553.333333333333485,609.508180603199321,4660.000000000000000,3,1029,1,33.3333015,1029,1,33.3333015,1223,2408
2764,4.000000000000000,0.000277777777778,760,967,207,844.250000000000000,75.886016498430067,3377.000000000000000,4,760,1,25.0000000,760,1,25.0000000,817,967
2765,4.000000000000000,0.000277777777778,45,481,436,243.500000000000000,186.940498555021520,974.000000000000000,4,45,1,25.0000000,45,1,25.0000000,77,481
2766,4.000000000000000,0.000277777777778,802,1483,681,1074.750000000000000,270.319602507846241,4299.000000000000000,4,802,1,25.0000000,802,1,25.0000000,862,1483
2767,4.000000000000000,0.000277777777778,304,1152,848,780.000000000000000,305.027867579341034,3120.000000000000000,4,304,1,25.0000000,304,1,25.0000000,802,1152
2768,4.000000000000000,0.000277777777778,304,1152,848,780.000000000000000,305.027867579341034,3120.000000000000000,4,304,1,25.0000000,304,1,25.0000000,802,1152
2769,4.000000000000000,0.000277777777778,535,893,358,655.750000000000000,139.945301814673286,2623.000000000000000,4,535,1,25.0000000,535,1,25.0000000,579,893
2770,4.000000000000000,0.000277777777778,32,1110,1078,370.500000000000000,435.643489564575077,1482.000000000000000,4,32,1,25.0000000,32,1,25.0000000,77,1110
2771,5.000000000000000,0.000347222222222,110,1267,1157,823.000000000000000,394.481431755665767,4115.000000000000000,5,110,1,20.0000000,110,1,20.0000000,978,1267
2772,4.000000000000000,0.000277777777778,830,1950,1120,1196.750000000000000,451.067276024319881,4787.000000000000000,4,830,1,25.0000000,830,1,25.0000000,867,1950
2773,4.000000000000000,0.000277777777778,830,1425,595,1065.500000000000000,239.610621634350792,4262.000000000000000,4,830,1,25.0000000,830,1,25.0000000,867,1425
2774,4.000000000000000,0.000277777777778,846,7075,6229,2473.750000000000000,2657.472989044291353,9895.000000000000000,4,846,1,25.0000000,846,1,25.0000000,929,7075
2775,4.000000000000000,0.000277777777778,92,1067,975,608.500000000000000,360.506934746060097,2434.000000000000000,4,92,1,25.0000000,92,1,25.0000000,494,1067
2776,4.000000000000000,0.000277777777778,92,1067,975,608.500000000000000,360.506934746060097,2434.000000000000000,4,92,1,25.0000000,92,1,25.0000000,494,1067
2777,4.000000000000000,0.000277777777778,242,739,497,433.750000000000000,194.408558196392164,1735.000000000000000,4,242,1,25.0000000,242,1,25.0000000,291,739
2778,5.000000000000000,0.000347222222222,626,954,328,800.000000000000000,114.289107092495911,4000.000000000000000,5,626,1,20.0000000,626,1,20.0000000,830,954
2779,4.000000000000000,0.000277777777778,381,954,573,758.000000000000000,222.266731653659747,3032.000000000000000,4,381,1,25.0000000,381,1,25.0000000,830,954
2780,4.000000000000000,0.000277777777778,626,954,328,783.250000000000000,122.166638244653342,3133.000000000000000,4,626,1,25.0000000,626,1,25.0000000,723,954
2781,4.000000000000000,0.000277777777778,797,1825,1028,1356.500000000000000,367.608827423934429,5426.000000000000000,4,797,1,25.0000000,797,1,25.0000000,1358,1825
2782,4.000000000000000,0.000277777777778,829,1081,252,940.500000000000000,113.369969568664871,3762.000000000000000,3,829,2,50.0000000,1023,1,25.0000000,829,1081
2783,4.000000000000000,0.000277777777778,833,1902,1069,1398.500000000000000,388.984896879043390,5594.000000000000000,4,833,1,25.0000000,833,1,25.0000000,1307,1902
2784,4.000000000000000,0.000277777777778,833,1902,1069,1398.500000000000000,388.984896879043390,5594.000000000000000,4,833,1,25.0000000,833,1,25.0000000,1307,1902
2785,4.000000000000000,0.000277777777778,737,1125,388,840.500000000000000,164.341869284732212,3362.000000000000000,3,750,2,50.0000000,737,1,25.0000000,750,1125
2786,4.000000000000000,0.000277777777778,71,261,190,181.250000000000000,76.329466787080335,725.000000000000000,4,71,1,25.0000000,71,1,25.0000000,150,261
2787,4.000000000000000,0.000277777777778,81,966,885,529.250000000000000,366.955974879821269,2117.000000000000000,4,81,1,25.0000000,81,1,25.0000000,264,966
2788,4.000000000000000,0.000277777777778,696,2305,1609,1252.000000000000000,623.067010842333048,5008.000000000000000,4,696,1,25.0000000,696,1,25.0000000,928,2305
2789,3.000000000000000,0.000208333333333,375,1933,1558,1120.000000000000000,637.865712095160916,3360.000000000000000,3,375,1,33.3333015,375,1,33.3333015,1052,1933
2790,4.000000000000000,0.000277777777778,311,2036,1725,966.250000000000000,716.880873995115053,3865.000000000000000,4,311,1,25.0000000,311,1,25.0000000,314,2036
2791,3.000000000000000,0.000208333333333,476,3663,3187,1650.333333333333485,1429.765559647998998,4951.000000000000000,3,476,1,33.3333015,476,1,33.3333015,812,3663
2792,4.000000000000000,0.000277777777778,84,1156,1072,644.500000000000000,428.308592022154073,2578.000000000000000,4,84,1,25.0000000,84,1,25.0000000,389,1156
2793,4.000000000000000,0.000277777777778,477,1007,530,650.000000000000000,209.019137879764486,2600.000000000000000,4,477,1,25.0000000,477,1,25.0000000,543,1007
2794,4.000000000000000,0.000277777777778,218,3843,3625,1219.750000000000000,1518.090309401914283,4879.000000000000000,4,218,1,25.0000000,218,1,25.0000000,312,3843
2795,4.000000000000000,0.000277777777778,56,2113,2057,869.000000000000000,761.903865326853406,3476.000000000000000,4,56,1,25.0000000,56,1,25.0000000,552,2113
2796,4.000000000000000,0.000277777777778,1410,2185,775,1669.750000000000000,302.321331533188356,6679.000000000000000,3,1542,2,50.0000000,1410,1,25.0000000,1542,2185
2797,4.000000000000000,0.000277777777778,866,1925,1059,1570.000000000000000,419.390629365988559,6280.000000000000000,4,866,1,25.0000000,866,1,25.0000000,1642,1925
2798,4.000000000000000,0.000277777777778,202,3073,2871,1301.250000000000000,1169.548711041998558,5205.000000000000000,4,202,1,25.0000000,202,1,25.0000000,295,3073
2799,3.000000000000000,0.000208333333333,294,2091,1797,992.000000000000000,786.512555525975017,2976.000000000000000,3,294,1,33.3333015,294,1,33.3333015,591,2091
2800,4.000000000000000,0.000277777777778,294,2091,1797,858.750000000000000,719.178828595503091,3435.000000000000000,4,294,1,25.0000000,294,1,25.0000000,459,2091
2801,4.000000000000000,0.000277777777778,31,3886,3855,2086.750000000000000,1534.684556350261801,8347.000000000000000,4,31,1,25.0000000,31,1,25.0000000,1234,3886
2802,4.000000000000000,0.000277777777778,40,2268,2228,897.750000000000000,880.336973834451669,3591.000000000000000,4,40,1,25.0000000,40,1,25.0000000,220,2268
2803,4.000000000000000,0.000277777777778,552,1663,1111,1142.500000000000000,485.917945748044986,4570.000000000000000,4,552,1,25.0000000,552,1,25.0000000,776,1663
2804,5.000000000000000,0.000347222222222,1013,2365,1352,1578.599999999999909,513.735574006706315,7893.000000000000000,5,1013,1,20.0000000,1013,1,20.0000000,1521,2365
2805,4.000000000000000,0.000277777777778,628,3695,3067,1885.250000000000000,1191.288037168173787,7541.000000000000000,4,628,1,25.0000000,628,1,25.0000000,1031,3695
2806,4.000000000000000,0.000277777777778,636,2459,1823,1302.750000000000000,689.446653121182408,5211.000000000000000,4,636,1,25.0000000,636,1,25.0000000,1052,2459
2807,4.000000000000000,0.000277777777778,636,2459,1823,1302.750000000000000,689.446653121182408,5211.000000000000000,4,636,1,25.0000000,636,1,25.0000000,1052,2459
2808,4.000000000000000,0.000277777777778,636,2459,1823,1302.750000000000000,689.446653121182408,5211.000000000000000,4,636,1,25.0000000,636,1,25.0000000,1052,2459
2809,4.000000000000000,0.000277777777778,636,2459,1823,1302.750000000000000,689.446653121182408,5211.000000000000000,4,636,1,25.0000000,636,1,25.0000000,1052,2459
2810,4.000000000000000,0.000277777777778,723,2955,2232,1715.250000000000000,917.194192905733530,6861.000000000000000,4,723,1,25.0000000,723,1,25.0000000,954,2955
2811,4.000000000000000,0.000277777777778,834,2955,2121,1743.000000000000000,887.967060199870275,6972.000000000000000,4,834,1,25.0000000,834,1,25.0000000,954,2955
2812,4.000000000000000,0.000277777777778,723,2955,2232,1715.250000000000000,917.194192905733530,6861.000000000000000,4,723,1,25.0000000,723,1,25.0000000,954,2955
2813,4.000000000000000,0.000277777777778,400,724,324,554.750000000000000,144.224434476270346,2219.000000000000000,4,400,1,25.0000000,400,1,25.0000000,424,724
2814,4.000000000000000,0.000277777777778,118,5660,5542,1942.250000000000227,2177.561064011753388,7769.000000000000000,4,118,1,25.0000000,118,1,25.0000000,884,5660
2815,4.000000000000000,0.000277777777778,21,505,484,216.000000000000000,194.907670449369448,864.000000000000000,4,21,1,25.0000000,21,1,25.0000000,55,505
2816,4.000000000000000,0.000277777777778,444,2209,1765,1420.250000000000000,791.204580054994381,5681.000000000000000,4,444,1,25.0000000,444,1,25.0000000,839,2209
2817,4.000000000000000,0.000277777777778,125,1191,1066,544.750000000000000,405.881987158829190,2179.000000000000000,4,125,1,25.0000000,125,1,25.0000000,291,1191
2818,4.000000000000000,0.000277777777778,160,1129,969,781.750000000000000,379.335850533534483,3127.000000000000000,4,160,1,25.0000000,160,1,25.0000000,795,1129
2819,4.000000000000000,0.000277777777778,160,1129,969,579.250000000000000,401.382844052906648,2317.000000000000000,4,160,1,25.0000000,160,1,25.0000000,233,1129
2820,4.000000000000000,0.000277777777778,160,1129,969,781.750000000000000,379.335850533534483,3127.000000000000000,4,160,1,25.0000000,160,1,25.0000000,795,1129
2821,4.000000000000000,0.000277777777778,38,3311,3273,1626.000000000000000,1568.813086380911045,6504.000000000000000,4,38,1,25.0000000,38,1,25.0000000,81,3311
2822,3.000000000000000,0.000208333333333,678,1167,489,892.333333333333258,204.141018797192146,2677.000000000000000,3,678,1,33.3333015,678,1,33.3333015,832,1167
2823,4.000000000000000,0.000277777777778,538,903,365,693.250000000000000,131.940090571440805,2773.000000000000000,4,538,1,25.0000000,538,1,25.0000000,661,903
2824,4.000000000000000,0.000277777777778,895,3183,2288,1744.250000000000000,862.126259604705524,6977.000000000000000,4,895,1,25.0000000,895,1,25.0000000,1386,3183
2825,5.000000000000000,0.000347222222222,637,1462,825,937.600000000000023,324.243488754978671,4688.000000000000000,5,637,1,20.0000000,637,1,20.0000000,743,1462
2826,5.000000000000000,0.000347222222222,332,1534,1202,725.399999999999977,424.525429155898792,3627.000000000000000,5,332,1,20.0000000,332,1,20.0000000,565,1534
2827,4.000000000000000,0.000277777777778,342,4217,3875,2258.250000000000000,1669.522442945886269,9033.000000000000000,4,342,1,25.0000000,342,1,25.0000000,888,4217
2828,4.000000000000000,0.000277777777778,1152,3205,2053,2105.250000000000000,729.840179422865162,8421.000000000000000,4,1152,1,25.0000000,1152,1,25.0000000,2002,3205
2829,4.000000000000000,0.000277777777778,203,2067,1864,805.500000000000000,737.000848032076533,3222.000000000000000,4,203,1,25.0000000,203,1,25.0000000,452,2067
2830,3.000000000000000,0.000208333333333,26,519,493,239.333333333333314,206.659677301166397,718.000000000000000,3,26,1,33.3333015,26,1,33.3333015,173,519
2831,4.000000000000000,0.000277777777778,1730,2512,782,2188.000000000000000,284.524164175909675,8752.000000000000000,4,1730,1,25.0000000,1730,1,25.0000000,2248,2512
2832,4.000000000000000,0.000277777777778,96,2901,2805,1124.250000000000000,1112.998736522193894,4497.000000000000000,4,96,1,25.0000000,96,1,25.0000000,270,2901
2833,4.000000000000000,0.000277777777778,322,2947,2625,1206.500000000000000,1031.607119983184248,4826.000000000000000,4,322,1,25.0000000,322,1,25.0000000,580,2947
2834,4.000000000000000,0.000277777777778,894,1046,152,959.000000000000000,56.156032623396747,3836.000000000000000,4,894,1,25.0000000,894,1,25.0000000,931,1046
2835,4.000000000000000,0.000277777777778,626,2414,1788,1323.750000000000000,694.539550709676973,5295.000000000000000,4,626,1,25.0000000,626,1,25.0000000,830,2414
2836,5.000000000000000,0.000347222222222,295,2414,2119,1380.599999999999909,824.510667001949741,6903.000000000000000,5,295,1,20.0000000,295,1,20.0000000,1425,2414
2837,4.000000000000000,0.000277777777778,224,1051,827,635.250000000000000,300.660418911435670,2541.000000000000000,4,224,1,25.0000000,224,1,25.0000000,534,1051
2838,5.000000000000000,0.000347222222222,224,1092,868,726.600000000000023,325.110196702594976,3633.000000000000000,5,224,1,20.0000000,224,1,20.0000000,732,1092
2839,4.000000000000000,0.000277777777778,94,1698,1604,681.000000000000000,645.609402038105486,2724.000000000000000,4,94,1,25.0000000,94,1,25.0000000,153,1698
2840,5.000000000000000,0.000347222222222,669,938,269,793.799999999999955,90.828189456798043,3969.000000000000000,5,669,1,20.0000000,669,1,20.0000000,806,938
2841,4.000000000000000,0.000277777777778,0,1297,1297,653.000000000000000,459.861392160724904,2612.000000000000000,4,0,1,25.0000000,0,1,25.0000000,609,1297
2842,4.000000000000000,0.000277777777778,0,1297,1297,653.000000000000000,459.861392160724904,2612.000000000000000,4,0,1,25.0000000,0,1,25.0000000,609,1297
2843,4.000000000000000,0.000277777777778,381,1297,916,748.250000000000000,338.073494228695779,2993.000000000000000,4,381,1,25.0000000,381,1,25.0000000,609,1297
2844,4.000000000000000,0.000277777777778,801,3356,2555,1622.250000000000000,1026.025188530963987,6489.000000000000000,4,801,1,25.0000000,801,1,25.0000000,927,3356
2845,4.000000000000000,0.000277777777778,221,1171,950,679.750000000000000,459.325252408356107,2719.000000000000000,3,221,2,50.0000000,1106,1,25.0000000,221,1171
2846,4.000000000000000,0.000277777777778,310,5895,5585,2844.750000000000000,2038.428607408167409,11379.000000000000000,4,310,1,25.0000000,310,1,25.0000000,1971,5895
2847,4.000000000000000,0.000277777777778,411,2229,1818,1168.000000000000000,692.220340643064333,4672.000000000000000,4,411,1,25.0000000,411,1,25.0000000,723,2229
2848,4.000000000000000,0.000277777777778,380,689,309,556.000000000000000,112.909255599352875,2224.000000000000000,4,380,1,25.0000000,380,1,25.0000000,551,689
2849,4.000000000000000,0.000277777777778,285,1129,844,763.250000000000000,341.668241866287588,3053.000000000000000,4,285,1,25.0000000,285,1,25.0000000,598,1129
2850,5.000000000000000,0.000347222222222,1047,4244,3197,2155.599999999999909,1178.207553871557820,10778.000000000000000,5,1047,1,20.0000000,1047,1,20.0000000,1510,4244
2851,4.000000000000000,0.000277777777778,67,89,22,74.750000000000000,9.010410645470049,299.000000000000000,3,67,2,50.0000000,76,1,25.0000000,67,89
2852,4.000000000000000,0.000277777777778,85,438,353,309.000000000000000,136.574155681080470,1236.000000000000000,4,85,1,25.0000000,85,1,25.0000000,316,438
2853,4.000000000000000,0.000277777777778,829,3169,2340,1499.750000000000000,966.281888218960717,5999.000000000000000,4,829,1,25.0000000,829,1,25.0000000,1000,3169
2854,3.000000000000000,0.000208333333333,177,966,789,620.666666666666742,329.527270832357999,1862.000000000000000,3,177,1,33.3333015,177,1,33.3333015,719,966
2855,4.000000000000000,0.000277777777778,177,966,789,531.500000000000000,324.489213996397723,2126.000000000000000,4,177,1,25.0000000,177,1,25.0000000,264,966
2856,4.000000000000000,0.000277777777778,749,864,115,798.000000000000000,46.802777695346251,3192.000000000000000,4,749,1,25.0000000,749,1,25.0000000,759,864
2857,4.000000000000000,0.000277777777778,749,864,115,798.000000000000000,46.802777695346251,3192.000000000000000,4,749,1,25.0000000,749,1,25.0000000,759,864
2858,4.000000000000000,0.000277777777778,125,1164,1039,685.000000000000000,371.720997523680410,2740.000000000000000,4,125,1,25.0000000,125,1,25.0000000,669,1164
2859,4.000000000000000,0.000277777777778,125,1164,1039,685.000000000000000,371.720997523680410,2740.000000000000000,4,125,1,25.0000000,125,1,25.0000000,669,1164
2860,4.000000000000000,0.000277777777778,865,1912,1047,1263.000000000000000,396.536883530397404,5052.000000000000000,4,865,1,25.0000000,865,1,25.0000000,1043,1912
2861,4.000000000000000,0.000277777777778,35,1104,1069,376.000000000000000,435.909967768574916,1504.000000000000000,4,35,1,25.0000000,35,1,25.0000000,43,1104
2862,4.000000000000000,0.000277777777778,35,1104,1069,376.000000000000000,435.909967768574916,1504.000000000000000,4,35,1,25.0000000,35,1,25.0000000,43,1104
2863,4.000000000000000,0.000277777777778,52,1486,1434,702.750000000000000,555.341955465279057,2811.000000000000000,4,52,1,25.0000000,52,1,25.0000000,330,1486
2864,4.000000000000000,0.000277777777778,18,1846,1828,607.000000000000000,743.049796447048379,2428.000000000000000,4,18,1,25.0000000,18,1,25.0000000,42,1846
2865,4.000000000000000,0.000277777777778,18,1846,1828,607.000000000000000,743.049796447048379,2428.000000000000000,4,18,1,25.0000000,18,1,25.0000000,42,1846
2866,4.000000000000000,0.000277777777778,168,704,536,477.500000000000000,221.097829025976637,1910.000000000000000,4,168,1,25.0000000,168,1,25.0000000,369,704
2867,4.000000000000000,0.000277777777778,505,848,343,674.250000000000000,140.396536638194874,2697.000000000000000,4,505,1,25.0000000,505,1,25.0000000,572,848
2868,4.000000000000000,0.000277777777778,593,1178,585,883.750000000000000,211.729042646491934,3535.000000000000000,4,593,1,25.0000000,593,1,25.0000000,818,1178
2869,4.000000000000000,0.000277777777778,593,1178,585,883.750000000000000,211.729042646491934,3535.000000000000000,4,593,1,25.0000000,593,1,25.0000000,818,1178
2870,4.000000000000000,0.000277777777778,40,1635,1595,487.500000000000000,666.516503921695858,1950.000000000000000,4,40,1,25.0000000,40,1,25.0000000,51,1635
2871,3.000000000000000,0.000208333333333,1052,1895,843,1488.666666666666742,344.821048597030313,4466.000000000000000,3,1052,1,33.3333015,1052,1,33.3333015,1519,1895
2872,4.000000000000000,0.000277777777778,234,1144,910,747.000000000000000,331.307259202088744,2988.000000000000000,4,234,1,25.0000000,234,1,25.0000000,729,1144
2873,4.000000000000000,0.000277777777778,420,1617,1197,828.500000000000000,464.695868283762593,3314.000000000000000,4,420,1,25.0000000,420,1,25.0000000,600,1617
2874,6.000000000000000,0.000416666666667,178,1058,880,486.500000000000000,287.627507956616284,2919.000000000000000,6,178,1,16.6667004,178,1,16.6667004,411,546
2875,3.000000000000000,0.000208333333333,28,215,187,122.333333333333329,76.351526216281727,367.000000000000000,3,28,1,33.3333015,28,1,33.3333015,124,215
2876,5.000000000000000,0.000347222222222,206,8996,8790,2244.800000000000182,3385.610219738828619,11224.000000000000000,5,206,1,20.0000000,206,1,20.0000000,549,8996
2877,4.000000000000000,0.000277777777778,569,1202,633,1002.500000000000000,257.973351336916210,4010.000000000000000,4,569,1,25.0000000,569,1,25.0000000,1045,1202
2878,4.000000000000000,0.000277777777778,137,826,689,389.000000000000000,283.094507187970692,1556.000000000000000,4,137,1,25.0000000,137,1,25.0000000,140,826
2879,4.000000000000000,0.000277777777778,475,789,314,649.000000000000000,117.957619508025005,2596.000000000000000,4,475,1,25.0000000,475,1,25.0000000,615,789
2880,4.000000000000000,0.000277777777778,425,2005,1580,1051.750000000000000,592.942398129868934,4207.000000000000000,4,425,1,25.0000000,425,1,25.0000000,728,2005
2881,4.000000000000000,0.000277777777778,782,1699,917,1067.750000000000000,372.831982936013674,4271.000000000000000,4,782,1,25.0000000,782,1,25.0000000,805,1699
2882,3.000000000000000,0.000208333333333,437,1043,606,727.000000000000000,248.080632053370920,2181.000000000000000,3,437,1,33.3333015,437,1,33.3333015,701,1043
2883,4.000000000000000,0.000277777777778,804,2326,1522,1724.750000000000000,621.557469185271771,6899.000000000000000,4,804,1,25.0000000,804,1,25.0000000,1507,2326
2884,4.000000000000000,0.000277777777778,215,3256,3041,1176.250000000000000,1213.260560432094508,4705.000000000000000,4,215,1,25.0000000,215,1,25.0000000,536,3256
2885,5.000000000000000,0.000347222222222,561,677,116,621.000000000000000,47.040408161494526,3105.000000000000000,5,561,1,20.0000000,561,1,20.0000000,605,677
2886,4.000000000000000,0.000277777777778,79,2219,2140,722.000000000000000,869.415608325500443,2888.000000000000000,4,79,1,25.0000000,79,1,25.0000000,248,2219
2887,4.000000000000000,0.000277777777778,374,1388,1014,809.000000000000000,385.581379218447239,3236.000000000000000,4,374,1,25.0000000,374,1,25.0000000,564,1388
2888,4.000000000000000,0.000277777777778,159,1388,1229,755.250000000000000,451.777254296849264,3021.000000000000000,4,159,1,25.0000000,159,1,25.0000000,564,1388
2889,4.000000000000000,0.000277777777778,159,1388,1229,755.250000000000000,451.777254296849264,3021.000000000000000,4,159,1,25.0000000,159,1,25.0000000,564,1388
2890,4.000000000000000,0.000277777777778,269,1437,1168,849.750000000000000,436.392813300127614,3399.000000000000000,4,269,1,25.0000000,269,1,25.0000000,647,1437
2891,4.000000000000000,0.000277777777778,933,2644,1711,1791.250000000000000,751.264059768600987,7165.000000000000000,4,933,1,25.0000000,933,1,25.0000000,1164,2644
2892,4.000000000000000,0.000277777777778,101,1518,1417,771.250000000000000,558.535305508971419,3085.000000000000000,4,101,1,25.0000000,101,1,25.0000000,388,1518
2893,4.000000000000000,0.000277777777778,712,2296,1584,1601.250000000000000,609.850545215792977,6405.000000000000000,4,712,1,25.0000000,712,1,25.0000000,1386,2296
2894,4.000000000000000,0.000277777777778,100,782,682,376.750000000000000,286.303488452376371,1507.000000000000000,4,100,1,25.0000000,100,1,25.0000000,114,782
2895,4.000000000000000,0.000277777777778,224,979,755,686.750000000000000,281.639286144529194,2747.000000000000000,4,224,1,25.0000000,224,1,25.0000000,732,979
2896,5.000000000000000,0.000347222222222,656,3643,2987,1380.599999999999909,1142.679412608803432,6903.000000000000000,5,656,1,20.0000000,656,1,20.0000000,745,3643
2897,4.000000000000000,0.000277777777778,601,3600,2999,1413.000000000000000,1265.415939523443740,5652.000000000000000,4,601,1,25.0000000,601,1,25.0000000,632,3600
2898,5.000000000000000,0.000347222222222,344,1694,1350,1092.599999999999909,497.476672819942337,5463.000000000000000,5,344,1,20.0000000,344,1,20.0000000,1006,1694
2899,5.000000000000000,0.000347222222222,67,1408,1341,388.000000000000000,513.204052984775217,1940.000000000000000,5,67,1,20.0000000,67,1,20.0000000,143,1408
2900,4.000000000000000,0.000277777777778,17,1397,1380,657.750000000000000,505.155112316999123,2631.000000000000000,4,17,1,25.0000000,17,1,25.0000000,437,1397
2901,4.000000000000000,0.000277777777778,834,2955,2121,1743.000000000000000,887.967060199870275,6972.000000000000000,4,834,1,25.0000000,834,1,25.0000000,954,2955
2902,4.000000000000000,0.000277777777778,752,1939,1187,1085.750000000000000,493.581996734078587,4343.000000000000000,4,752,1,25.0000000,752,1,25.0000000,818,1939
2903,4.000000000000000,0.000277777777778,731,1065,334,848.000000000000000,134.210655314695487,3392.000000000000000,4,731,1,25.0000000,731,1,25.0000000,742,1065
2904,4.000000000000000,0.000277777777778,0,1297,1297,653.000000000000000,459.861392160724904,2612.000000000000000,4,0,1,25.0000000,0,1,25.0000000,609,1297
2905,4.000000000000000,0.000277777777778,0,1095,1095,602.500000000000000,392.529298269568642,2410.000000000000000,4,0,1,25.0000000,0,1,25.0000000,609,1095
2906,3.000000000000000,0.000208333333333,609,1095,486,803.333333333333371,210.006878194236492,2410.000000000000000,3,609,1,33.3333015,609,1,33.3333015,706,1095
2907,4.000000000000000,0.000277777777778,609,1950,1341,1090.000000000000000,528.782091224731289,4360.000000000000000,4,609,1,25.0000000,609,1,25.0000000,706,1950
2908,4.000000000000000,0.000277777777778,243,2729,2486,1173.250000000000000,937.264737147408141,4693.000000000000000,4,243,1,25.0000000,243,1,25.0000000,733,2729
2909,3.000000000000000,0.000208333333333,124,1292,1168,705.333333333333371,476.848916208151707,2116.000000000000000,3,124,1,33.3333015,124,1,33.3333015,700,1292
2910,3.000000000000000,0.000208333333333,415,970,555,756.333333333333371,243.899341714751046,2269.000000000000000,3,415,1,33.3333015,415,1,33.3333015,884,970
2911,4.000000000000000,0.000277777777778,47,10048,10001,3293.750000000000000,3958.773002774975794,13175.000000000000000,4,47,1,25.0000000,47,1,25.0000000,1107,10048
2912,4.000000000000000,0.000277777777778,407,1212,805,727.250000000000000,312.583888740286795,2909.000000000000000,4,407,1,25.0000000,407,1,25.0000000,504,1212
2913,4.000000000000000,0.000277777777778,643,3192,2549,1756.750000000000000,1121.811119351203388,7027.000000000000000,4,643,1,25.0000000,643,1,25.0000000,679,3192
2914,4.000000000000000,0.000277777777778,85,2491,2406,1253.250000000000000,963.004770237406433,5013.000000000000000,4,85,1,25.0000000,85,1,25.0000000,582,2491
2915,3.000000000000000,0.000208333333333,582,2491,1909,1642.666666666666515,793.676816398771280,4928.000000000000000,3,582,1,33.3333015,582,1,33.3333015,1855,2491
2916,4.000000000000000,0.000277777777778,33,1114,1081,693.750000000000000,413.573073954289271,2775.000000000000000,4,33,1,25.0000000,33,1,25.0000000,669,1114
2917,4.000000000000000,0.000277777777778,846,7075,6229,2473.750000000000000,2657.472989044291353,9895.000000000000000,4,846,1,25.0000000,846,1,25.0000000,929,7075
2918,4.000000000000000,0.000277777777778,317,3876,3559,1689.000000000000000,1330.364423757640907,6756.000000000000000,4,317,1,25.0000000,317,1,25.0000000,1079,3876
2919,3.000000000000000,0.000208333333333,124,2834,2710,1451.000000000000000,1107.061275028020646,4353.000000000000000,3,124,1,33.3333015,124,1,33.3333015,1395,2834
2920,5.000000000000000,0.000347222222222,208,2880,2672,1218.000000000000000,949.429934223689770,6090.000000000000000,5,208,1,20.0000000,208,1,20.0000000,921,2880
2921,4.000000000000000,0.000277777777778,857,1228,371,1056.750000000000000,131.940090571440805,4227.000000000000000,3,1071,2,50.0000000,857,1,25.0000000,1071,1228
2922,4.000000000000000,0.000277777777778,348,2066,1718,1119.500000000000000,617.340465221582576,4478.000000000000000,4,348,1,25.0000000,348,1,25.0000000,937,2066
2923,4.000000000000000,0.000277777777778,448,3377,2929,1359.750000000000000,1174.586389968826325,5439.000000000000000,4,448,1,25.0000000,448,1,25.0000000,748,3377
2924,4.000000000000000,0.000277777777778,936,1607,671,1123.000000000000000,279.906234299988341,4492.000000000000000,4,936,1,25.0000000,936,1,25.0000000,969,1607
2925,4.000000000000000,0.000277777777778,890,3964,3074,2833.500000000000000,1161.839597362734139,11334.000000000000000,4,890,1,25.0000000,890,1,25.0000000,3157,3964
2926,4.000000000000000,0.000277777777778,60,2191,2131,911.249999999999886,798.868066391441175,3645.000000000000000,4,60,1,25.0000000,60,1,25.0000000,475,2191
2927,4.000000000000000,0.000277777777778,636,1569,933,1118.500000000000000,343.870978711492853,4474.000000000000000,4,636,1,25.0000000,636,1,25.0000000,999,1569
2928,4.000000000000000,0.000277777777778,580,1856,1276,1015.000000000000000,501.456877507926890,4060.000000000000000,4,580,1,25.0000000,580,1,25.0000000,696,1856
2929,4.000000000000000,0.000277777777778,580,928,348,703.500000000000000,136.428552729991253,2814.000000000000000,4,580,1,25.0000000,580,1,25.0000000,610,928
2930,4.000000000000000,0.000277777777778,111,1180,1069,744.750000000000000,457.322301555478475,2979.000000000000000,3,1180,2,50.0000000,111,1,25.0000000,508,1180
2931,3.000000000000000,0.000208333333333,662,1084,422,925.000000000000000,187.319691080961007,2775.000000000000000,3,662,1,33.3333015,662,1,33.3333015,1029,1084
2932,4.000000000000000,0.000277777777778,1,1091,1090,318.000000000000000,447.991629386085776,1272.000000000000000,4,1,1,25.0000000,1,1,25.0000000,70,1091
2933,4.000000000000000,0.000277777777778,72,207,135,163.750000000000000,54.320231037800276,655.000000000000000,4,72,1,25.0000000,72,1,25.0000000,175,207
2934,3.000000000000000,0.000208333333333,269,1437,1168,784.333333333333371,486.621915750707728,2353.000000000000000,3,269,1,33.3333015,269,1,33.3333015,647,1437
2935,4.000000000000000,0.000277777777778,56,755,699,364.500000000000000,298.097718877551983,1458.000000000000000,4,56,1,25.0000000,56,1,25.0000000,95,755
2936,4.000000000000000,0.000277777777778,56,2113,2057,869.000000000000000,761.903865326853406,3476.000000000000000,4,56,1,25.0000000,56,1,25.0000000,552,2113
2937,4.000000000000000,0.000277777777778,646,2005,1359,1188.500000000000000,499.632114660376885,4754.000000000000000,4,646,1,25.0000000,646,1,25.0000000,1049,2005
2938,4.000000000000000,0.000277777777778,568,994,426,852.250000000000000,167.666894466379375,3409.000000000000000,4,568,1,25.0000000,568,1,25.0000000,897,994
2939,4.000000000000000,0.000277777777778,0,1379,1379,612.250000000000000,607.596237233246825,2449.000000000000000,4,0,1,25.0000000,0,1,25.0000000,34,1379
2940,4.000000000000000,0.000277777777778,513,1946,1433,1331.750000000000000,571.838427792326684,5327.000000000000000,4,513,1,25.0000000,513,1,25.0000000,1088,1946
2941,6.000000000000000,0.000416666666667,1170,3038,1868,2085.500000000000000,611.882273535250192,12513.000000000000000,6,1170,1,16.6667004,1170,1,16.6667004,1916,2656
2942,4.000000000000000,0.000277777777778,129,489,360,340.750000000000000,150.213805956709592,1363.000000000000000,4,129,1,25.0000000,129,1,25.0000000,269,489
2943,4.000000000000000,0.000277777777778,224,1557,1333,1040.250000000000000,531.106568872952266,4161.000000000000000,4,224,1,25.0000000,224,1,25.0000000,916,1557
2944,4.000000000000000,0.000277777777778,1120,1596,476,1308.250000000000000,189.069266407843287,5233.000000000000000,4,1120,1,25.0000000,1120,1,25.0000000,1159,1596
2945,4.000000000000000,0.000277777777778,1159,2502,1343,1720.750000000000000,519.139371941678064,6883.000000000000000,4,1159,1,25.0000000,1159,1,25.0000000,1358,2502
2946,3.000000000000000,0.000208333333333,1159,2502,1343,1673.000000000000000,591.794446295896478,5019.000000000000000,3,1159,1,33.3333015,1159,1,33.3333015,1358,2502
2947,4.000000000000000,0.000277777777778,1120,1596,476,1308.250000000000000,189.069266407843287,5233.000000000000000,4,1120,1,25.0000000,1120,1,25.0000000,1159,1596
2948,4.000000000000000,0.000277777777778,347,969,622,623.250000000000000,230.154703406208938,2493.000000000000000,4,347,1,25.0000000,347,1,25.0000000,506,969
2949,4.000000000000000,0.000277777777778,643,2513,1870,1192.750000000000000,770.575231564057049,4771.000000000000000,4,643,1,25.0000000,643,1,25.0000000,679,2513
2950,4.000000000000000,0.000277777777778,643,2513,1870,1192.750000000000000,770.575231564057049,4771.000000000000000,4,643,1,25.0000000,643,1,25.0000000,679,2513
2951,5.000000000000000,0.000347222222222,288,3925,3637,2047.000000000000000,1351.006883772247875,10235.000000000000000,5,288,1,20.0000000,288,1,20.0000000,1391,3925
2952,4.000000000000000,0.000277777777778,447,1701,1254,890.500000000000000,484.807951667461850,3562.000000000000000,4,447,1,25.0000000,447,1,25.0000000,609,1701
2953,4.000000000000000,0.000277777777778,1555,8959,7404,3827.000000000000000,2994.976210256101695,15308.000000000000000,4,1555,1,25.0000000,1555,1,25.0000000,2016,8959
2954,3.000000000000000,0.000208333333333,969,1214,245,1107.666666666666742,102.600628111570984,3323.000000000000000,3,969,1,33.3333015,969,1,33.3333015,1140,1214
2955,4.000000000000000,0.000277777777778,456,606,150,533.750000000000000,56.313297719100056,2135.000000000000000,4,456,1,25.0000000,456,1,25.0000000,510,606
2956,4.000000000000000,0.000277777777778,159,3190,3031,1189.500000000000000,1176.344018559196911,4758.000000000000000,4,159,1,25.0000000,159,1,25.0000000,685,3190
2957,4.000000000000000,0.000277777777778,19,1928,1909,641.500000000000000,768.303488212828597,2566.000000000000000,4,19,1,25.0000000,19,1,25.0000000,88,1928
2958,4.000000000000000,0.000277777777778,721,2183,1462,1394.500000000000000,544.919030682540892,5578.000000000000000,4,721,1,25.0000000,721,1,25.0000000,1107,2183
2959,4.000000000000000,0.000277777777778,672,1153,481,880.500000000000000,192.884032516950441,3522.000000000000000,4,672,1,25.0000000,672,1,25.0000000,728,1153
2960,4.000000000000000,0.000277777777778,696,1330,634,1038.500000000000000,225.598648045594445,4154.000000000000000,3,1064,2,50.0000000,696,1,25.0000000,1064,1330
2961,5.000000000000000,0.000347222222222,372,1064,692,777.799999999999955,261.677970031869506,3889.000000000000000,4,1064,2,40.0000000,372,1,20.0000000,696,1064
2962,4.000000000000000,0.000277777777778,219,1244,1025,523.250000000000000,418.205915190112989,2093.000000000000000,4,219,1,25.0000000,219,1,25.0000000,295,1244
2963,4.000000000000000,0.000277777777778,219,1244,1025,523.250000000000000,418.205915190112989,2093.000000000000000,4,219,1,25.0000000,219,1,25.0000000,295,1244
2964,4.000000000000000,0.000277777777778,47,715,668,349.500000000000000,241.769001321509364,1398.000000000000000,4,47,1,25.0000000,47,1,25.0000000,260,715
2965,5.000000000000000,0.000347222222222,410,1620,1210,1073.000000000000000,435.742125574289673,5365.000000000000000,5,410,1,20.0000000,410,1,20.0000000,1109,1620
2966,4.000000000000000,0.000277777777778,481,3097,2616,1846.500000000000000,1064.207803955599729,7386.000000000000000,4,481,1,25.0000000,481,1,25.0000000,1164,3097
2967,3.000000000000000,0.000208333333333,80,2428,2348,989.333333333333371,1029.051774963512571,2968.000000000000000,3,80,1,33.3333015,80,1,33.3333015,460,2428
2968,4.000000000000000,0.000277777777778,133,2723,2590,810.750000000000000,1104.330651344967464,3243.000000000000000,4,133,1,25.0000000,133,1,25.0000000,185,2723
2969,4.000000000000000,0.000277777777778,60,1703,1643,1129.250000000000000,650.393102285071905,4517.000000000000000,4,60,1,25.0000000,60,1,25.0000000,1157,1703
2970,4.000000000000000,0.000277777777778,593,1178,585,883.750000000000000,211.729042646491934,3535.000000000000000,4,593,1,25.0000000,593,1,25.0000000,818,1178
2971,4.000000000000000,0.000277777777778,172,1177,1005,626.250000000000000,406.906853591826405,2505.000000000000000,4,172,1,25.0000000,172,1,25.0000000,306,1177
2972,4.000000000000000,0.000277777777778,205,2690,2485,1183.750000000000000,1034.713335905167469,4735.000000000000000,4,205,1,25.0000000,205,1,25.0000000,243,2690
2973,4.000000000000000,0.000277777777778,205,2690,2485,1183.750000000000000,1034.713335905167469,4735.000000000000000,4,205,1,25.0000000,205,1,25.0000000,243,2690
2974,4.000000000000000,0.000277777777778,736,2540,1804,1470.250000000000000,672.144469217741857,5881.000000000000000,4,736,1,25.0000000,736,1,25.0000000,1119,2540
2975,4.000000000000000,0.000277777777778,428,1994,1566,1026.000000000000000,596.289778547309993,4104.000000000000000,4,428,1,25.0000000,428,1,25.0000000,669,1994
2976,4.000000000000000,0.000277777777778,281,850,569,687.000000000000000,235.181844537370722,2748.000000000000000,4,281,1,25.0000000,281,1,25.0000000,796,850
2977,4.000000000000000,0.000277777777778,281,850,569,687.000000000000000,235.181844537370722,2748.000000000000000,4,281,1,25.0000000,281,1,25.0000000,796,850
2978,4.000000000000000,0.000277777777778,281,850,569,687.000000000000000,235.181844537370722,2748.000000000000000,4,281,1,25.0000000,281,1,25.0000000,796,850
2979,3.000000000000000,0.000208333333333,47,640,593,432.666666666666629,272.964385141277262,1298.000000000000000,3,47,1,33.3333015,47,1,33.3333015,611,640
2980,4.000000000000000,0.000277777777778,834,2955,2121,1583.250000000000000,812.107866911779183,6333.000000000000000,4,834,1,25.0000000,834,1,25.0000000,1247,2955
2981,3.000000000000000,0.000208333333333,381,2955,2574,1390.000000000000000,1121.968805270449593,4170.000000000000000,3,381,1,33.3333015,381,1,33.3333015,834,2955
2982,4.000000000000000,0.000277777777778,381,2955,2574,1366.750000000000000,972.487628456012771,5467.000000000000000,4,381,1,25.0000000,381,1,25.0000000,834,2955
2983,4.000000000000000,0.000277777777778,398,1243,845,903.500000000000000,350.295946308260909,3614.000000000000000,4,398,1,25.0000000,398,1,25.0000000,756,1243
2984,4.000000000000000,0.000277777777778,398,1243,845,996.500000000000000,348.165549703011266,3986.000000000000000,4,398,1,25.0000000,398,1,25.0000000,1128,1243
2985,4.000000000000000,0.000277777777778,614,1088,474,882.750000000000000,199.926705319724618,3531.000000000000000,4,614,1,25.0000000,614,1,25.0000000,767,1088
2986,4.000000000000000,0.000277777777778,363,2699,2336,1222.750000000000000,887.698252504757420,4891.000000000000000,4,363,1,25.0000000,363,1,25.0000000,767,2699
2987,4.000000000000000,0.000277777777778,140,1189,1049,505.000000000000000,428.361412827999743,2020.000000000000000,4,140,1,25.0000000,140,1,25.0000000,143,1189
2988,4.000000000000000,0.000277777777778,403,3115,2712,1826.500000000000000,1231.618751887125200,7306.000000000000000,4,403,1,25.0000000,403,1,25.0000000,805,3115
2989,4.000000000000000,0.000277777777778,711,8404,7693,2772.750000000000000,3253.184852955638689,11091.000000000000000,4,711,1,25.0000000,711,1,25.0000000,974,8404
2990,4.000000000000000,0.000277777777778,711,8404,7693,2768.750000000000000,3255.403152836834579,11075.000000000000000,4,711,1,25.0000000,711,1,25.0000000,958,8404
2991,4.000000000000000,0.000277777777778,180,1728,1548,1015.500000000000000,585.732234045557675,4062.000000000000000,4,180,1,25.0000000,180,1,25.0000000,795,1728
2992,4.000000000000000,0.000277777777778,315,1243,928,809.500000000000000,333.314791150947883,3238.000000000000000,4,315,1,25.0000000,315,1,25.0000000,769,1243
2993,4.000000000000000,0.000277777777778,357,2394,2037,969.500000000000000,837.990602572606463,3878.000000000000000,4,357,1,25.0000000,357,1,25.0000000,370,2394
2994,4.000000000000000,0.000277777777778,34,1036,1002,438.500000000000000,402.150158522907930,1754.000000000000000,4,34,1,25.0000000,34,1,25.0000000,110,1036
2995,4.000000000000000,0.000277777777778,294,948,654,475.750000000000000,273.803191179357896,1903.000000000000000,4,294,1,25.0000000,294,1,25.0000000,302,948
2996,5.000000000000000,0.000347222222222,334,2670,2336,1167.199999999999818,791.938735004166801,5836.000000000000000,4,869,2,40.0000000,334,1,20.0000000,869,2670
2997,5.000000000000000,0.000347222222222,146,951,805,589.600000000000023,259.325741105660370,2948.000000000000000,5,146,1,20.0000000,146,1,20.0000000,644,951
2998,4.000000000000000,0.000277777777778,403,1022,619,718.500000000000000,223.924652506149954,2874.000000000000000,4,403,1,25.0000000,403,1,25.0000000,658,1022
2999,4.000000000000000,0.000277777777778,403,791,388,617.000000000000000,139.422021216162250,2468.000000000000000,4,403,1,25.0000000,403,1,25.0000000,616,791
3000,4.000000000000000,0.000277777777778,75,1330,1255,710.250000000000000,506.750616674513765,2841.000000000000000,4,75,1,25.0000000,75,1,25.0000000,372,1330
3001,3.000000000000000,0.000208333333333,84,2270,2186,1170.000000000000000,892.485667485291629,3510.000000000000000,3,84,1,33.3333015,84,1,33.3333015,1156,2270
3002,3.000000000000000,0.000208333333333,84,1156,1072,456.666666666666629,494.859800572063307,1370.000000000000000,3,84,1,33.3333015,84,1,33.3333015,130,1156
3003,4.000000000000000,0.000277777777778,658,1243,585,963.250000000000000,207.226174746338472,3853.000000000000000,4,658,1,25.0000000,658,1,25.0000000,974,1243
3004,4.000000000000000,0.000277777777778,414,1148,734,839.000000000000000,273.094306055618802,3356.000000000000000,4,414,1,25.0000000,414,1,25.0000000,809,1148
3005,4.000000000000000,0.000277777777778,238,2016,1778,1113.250000000000000,826.444606431671218,4453.000000000000000,4,238,1,25.0000000,238,1,25.0000000,341,2016
3006,4.000000000000000,0.000277777777778,866,1654,788,1342.250000000000000,300.448310862284586,5369.000000000000000,4,866,1,25.0000000,866,1,25.0000000,1316,1654
3007,3.000000000000000,0.000208333333333,425,881,456,626.333333333333371,189.942681412636233,1879.000000000000000,3,425,1,33.3333015,425,1,33.3333015,573,881
3008,4.000000000000000,0.000277777777778,411,2229,1818,1168.000000000000000,692.220340643064333,4672.000000000000000,4,411,1,25.0000000,411,1,25.0000000,723,2229
3009,3.000000000000000,0.000208333333333,1079,2305,1226,1536.333333333333258,546.787791459254208,4609.000000000000000,3,1079,1,33.3333015,1079,1,33.3333015,1225,2305
3010,4.000000000000000,0.000277777777778,749,2305,1556,1339.500000000000000,583.491859411937298,5358.000000000000000,4,749,1,25.0000000,749,1,25.0000000,1079,2305
3011,4.000000000000000,0.000277777777778,749,2305,1556,1339.500000000000000,583.491859411937298,5358.000000000000000,4,749,1,25.0000000,749,1,25.0000000,1079,2305
3012,4.000000000000000,0.000277777777778,802,4284,3482,2191.250000000000000,1304.511283009848285,8765.000000000000000,4,802,1,25.0000000,802,1,25.0000000,1486,4284
3013,3.000000000000000,0.000208333333333,523,785,262,697.666666666666629,123.507984447250294,2093.000000000000000,2,785,2,66.6667023,523,1,33.3333015,785,785
3014,4.000000000000000,0.000277777777778,38,370,332,237.000000000000000,123.642630188782377,948.000000000000000,4,38,1,25.0000000,38,1,25.0000000,241,370
3015,4.000000000000000,0.000277777777778,83,1060,977,645.500000000000000,353.280695764713414,2582.000000000000000,4,83,1,25.0000000,83,1,25.0000000,714,1060
3016,4.000000000000000,0.000277777777778,156,699,543,509.500000000000000,209.798117246080153,2038.000000000000000,4,156,1,25.0000000,156,1,25.0000000,562,699
3017,4.000000000000000,0.000277777777778,829,1081,252,940.500000000000000,113.369969568664871,3762.000000000000000,3,829,2,50.0000000,1023,1,25.0000000,829,1081
3018,4.000000000000000,0.000277777777778,219,1244,1025,694.750000000000000,367.503996576907980,2779.000000000000000,4,219,1,25.0000000,219,1,25.0000000,589,1244
3019,4.000000000000000,0.000277777777778,651,1294,643,869.000000000000000,254.174152895214746,3476.000000000000000,4,651,1,25.0000000,651,1,25.0000000,699,1294
3020,5.000000000000000,0.000347222222222,131,5305,5174,2018.799999999999955,1896.110798450343736,10094.000000000000000,5,131,1,20.0000000,131,1,20.0000000,1353,5305
3021,4.000000000000000,0.000277777777778,448,5305,4857,2490.750000000000000,1838.575858511146635,9963.000000000000000,4,448,1,25.0000000,448,1,25.0000000,1353,5305
3022,4.000000000000000,0.000277777777778,816,1280,464,1075.000000000000000,168.301812230290608,4300.000000000000000,4,816,1,25.0000000,816,1,25.0000000,1065,1280
3023,6.000000000000000,0.000416666666667,401,4134,3733,1157.000000000000000,1336.851151026171692,6942.000000000000000,6,401,1,16.6667004,401,1,16.6667004,543,752
3024,3.000000000000000,0.000208333333333,937,2265,1328,1466.666666666666515,574.475026050354586,4400.000000000000000,3,937,1,33.3333015,937,1,33.3333015,1198,2265
3025,4.000000000000000,0.000277777777778,343,1175,832,678.750000000000000,328.137452144676729,2715.000000000000000,4,343,1,25.0000000,343,1,25.0000000,427,1175
3026,4.000000000000000,0.000277777777778,184,929,745,591.250000000000000,296.451829982545405,2365.000000000000000,4,184,1,25.0000000,184,1,25.0000000,440,929
3027,4.000000000000000,0.000277777777778,192,1926,1734,1049.000000000000000,771.405535370339521,4196.000000000000000,4,192,1,25.0000000,192,1,25.0000000,377,1926
3028,4.000000000000000,0.000277777777778,51,1090,1039,340.750000000000000,434.338217867136336,1363.000000000000000,4,51,1,25.0000000,51,1,25.0000000,68,1090
3029,4.000000000000000,0.000277777777778,364,1060,696,758.000000000000000,258.124969733654382,3032.000000000000000,4,364,1,25.0000000,364,1,25.0000000,715,1060
3030,4.000000000000000,0.000277777777778,381,954,573,758.000000000000000,222.266731653659747,3032.000000000000000,4,381,1,25.0000000,381,1,25.0000000,830,954
3031,4.000000000000000,0.000277777777778,381,954,573,758.000000000000000,222.266731653659747,3032.000000000000000,4,381,1,25.0000000,381,1,25.0000000,830,954
3032,3.000000000000000,0.000208333333333,253,1124,871,777.333333333333371,377.124500515266050,2332.000000000000000,3,253,1,33.3333015,253,1,33.3333015,955,1124
3033,5.000000000000000,0.000347222222222,73,1966,1893,1114.400000000000091,799.715599447703767,5572.000000000000000,5,73,1,20.0000000,73,1,20.0000000,1343,1966
3034,4.000000000000000,0.000277777777778,295,2414,2119,1616.750000000000000,815.409827939300840,6467.000000000000000,4,295,1,25.0000000,295,1,25.0000000,1615,2414
3035,4.000000000000000,0.000277777777778,1615,2726,1111,2224.500000000000000,407.904707008879654,8898.000000000000000,4,1615,1,25.0000000,1615,1,25.0000000,2143,2726
3036,4.000000000000000,0.000277777777778,133,1227,1094,697.250000000000000,492.074371919530051,2789.000000000000000,4,133,1,25.0000000,133,1,25.0000000,285,1227
3037,4.000000000000000,0.000277777777778,285,1227,942,846.500000000000000,374.880314233756451,3386.000000000000000,4,285,1,25.0000000,285,1,25.0000000,730,1227
3038,4.000000000000000,0.000277777777778,796,2502,1706,1682.000000000000000,607.787791914250306,6728.000000000000000,4,796,1,25.0000000,796,1,25.0000000,1620,2502
3039,4.000000000000000,0.000277777777778,1038,2502,1464,1742.500000000000000,522.666958971006693,6970.000000000000000,4,1038,1,25.0000000,1038,1,25.0000000,1620,2502
3040,5.000000000000000,0.000347222222222,1038,2502,1464,1721.000000000000000,469.460967493571275,8605.000000000000000,5,1038,1,20.0000000,1038,1,20.0000000,1635,2502
3041,3.000000000000000,0.000208333333333,209,894,685,483.666666666666629,295.646560759446118,1451.000000000000000,3,209,1,33.3333015,209,1,33.3333015,348,894
3042,4.000000000000000,0.000277777777778,476,609,133,525.750000000000000,51.513954420137466,2103.000000000000000,4,476,1,25.0000000,476,1,25.0000000,491,609
3043,4.000000000000000,0.000277777777778,659,5779,5120,2772.250000000000000,1865.754991283689378,11089.000000000000000,4,659,1,25.0000000,659,1,25.0000000,2229,5779
3044,4.000000000000000,0.000277777777778,415,884,469,717.250000000000000,186.412680630905584,2869.000000000000000,4,415,1,25.0000000,415,1,25.0000000,712,884
3045,5.000000000000000,0.000347222222222,1088,2808,1720,1728.000000000000000,608.753480482863438,8640.000000000000000,5,1088,1,20.0000000,1088,1,20.0000000,1554,2808
3046,4.000000000000000,0.000277777777778,1554,2397,843,2020.500000000000000,318.498430137418438,8082.000000000000000,4,1554,1,25.0000000,1554,1,25.0000000,1920,2397
3047,4.000000000000000,0.000277777777778,1088,1920,832,1458.000000000000000,314.206938179283384,5832.000000000000000,4,1088,1,25.0000000,1088,1,25.0000000,1270,1920
3048,4.000000000000000,0.000277777777778,234,845,611,583.250000000000000,220.906513032096910,2333.000000000000000,4,234,1,25.0000000,234,1,25.0000000,606,845
3049,4.000000000000000,0.000277777777778,417,876,459,724.750000000000000,187.410478629131092,2899.000000000000000,3,876,2,50.0000000,417,1,25.0000000,730,876
3050,4.000000000000000,0.000277777777778,300,876,576,695.500000000000000,235.993114306328863,2782.000000000000000,3,876,2,50.0000000,300,1,25.0000000,730,876
3051,5.000000000000000,0.000347222222222,555,1810,1255,1197.799999999999955,472.420744675760432,5989.000000000000000,5,555,1,20.0000000,555,1,20.0000000,1159,1810
3052,4.000000000000000,0.000277777777778,580,928,348,703.500000000000000,136.428552729991253,2814.000000000000000,4,580,1,25.0000000,580,1,25.0000000,610,928
3053,4.000000000000000,0.000277777777778,580,928,348,703.500000000000000,136.428552729991253,2814.000000000000000,4,580,1,25.0000000,580,1,25.0000000,610,928
3054,4.000000000000000,0.000277777777778,231,868,637,561.750000000000000,277.242109896747081,2247.000000000000000,4,231,1,25.0000000,231,1,25.0000000,346,868
3055,3.000000000000000,0.000208333333333,237,3618,3381,1364.000000000000000,1593.818684794478031,4092.000000000000000,2,237,2,66.6667023,3618,1,33.3333015,237,3618
3056,4.000000000000000,0.000277777777778,780,1207,427,999.750000000000000,152.481761204414227,3999.000000000000000,4,780,1,25.0000000,780,1,25.0000000,977,1207
3057,4.000000000000000,0.000277777777778,752,977,225,888.000000000000000,83.865964490966178,3552.000000000000000,4,752,1,25.0000000,752,1,25.0000000,894,977
3058,3.000000000000000,0.000208333333333,317,1484,1167,763.000000000000000,514.581383262161921,2289.000000000000000,3,317,1,33.3333015,317,1,33.3333015,488,1484
3059,4.000000000000000,0.000277777777778,831,1422,591,1122.750000000000000,217.068393599805319,4491.000000000000000,4,831,1,25.0000000,831,1,25.0000000,1036,1422
3060,4.000000000000000,0.000277777777778,287,2835,2548,1178.750000000000000,980.780906981778458,4715.000000000000000,4,287,1,25.0000000,287,1,25.0000000,704,2835
3061,4.000000000000000,0.000277777777778,622,1212,590,998.000000000000000,242.185879026833447,3992.000000000000000,4,622,1,25.0000000,622,1,25.0000000,948,1212
3062,5.000000000000000,0.000347222222222,797,1176,379,964.799999999999955,139.012805165567386,4824.000000000000000,5,797,1,20.0000000,797,1,20.0000000,983,1176
3063,4.000000000000000,0.000277777777778,224,1051,827,704.750000000000000,301.353094392607829,2819.000000000000000,4,224,1,25.0000000,224,1,25.0000000,732,1051
3064,5.000000000000000,0.000347222222222,224,1051,827,670.600000000000023,278.057260290034492,3353.000000000000000,5,224,1,20.0000000,224,1,20.0000000,732,1051
3065,4.000000000000000,0.000277777777778,894,996,102,961.000000000000000,39.452503089157737,3844.000000000000000,3,977,2,50.0000000,894,1,25.0000000,977,996
3066,5.000000000000000,0.000347222222222,104,1265,1161,677.000000000000000,408.837375982186813,3385.000000000000000,5,104,1,20.0000000,104,1,20.0000000,802,1265
3067,4.000000000000000,0.000277777777778,231,868,637,561.750000000000000,277.242109896747081,2247.000000000000000,4,231,1,25.0000000,231,1,25.0000000,346,868
3068,4.000000000000000,0.000277777777778,104,868,764,530.000000000000000,317.631862381594203,2120.000000000000000,4,104,1,25.0000000,104,1,25.0000000,346,868
3069,4.000000000000000,0.000277777777778,231,868,637,561.750000000000000,277.242109896747081,2247.000000000000000,4,231,1,25.0000000,231,1,25.0000000,346,868
3070,4.000000000000000,0.000277777777778,2250,3935,1685,2973.250000000000000,655.496519822950745,11893.000000000000000,4,2250,1,25.0000000,2250,1,25.0000000,2506,3935
3071,4.000000000000000,0.000277777777778,658,1738,1080,1168.750000000000000,384.961929935935359,4675.000000000000000,4,658,1,25.0000000,658,1,25.0000000,1084,1738
3072,4.000000000000000,0.000277777777778,130,307,177,189.500000000000000,72.057268890792685,758.000000000000000,4,130,1,25.0000000,130,1,25.0000000,131,307
3073,4.000000000000000,0.000277777777778,1002,1132,130,1066.250000000000000,46.563800317413978,4265.000000000000000,4,1002,1,25.0000000,1002,1,25.0000000,1055,1132
3074,3.000000000000000,0.000208333333333,784,4320,3536,2702.000000000000000,1459.069109626636646,8106.000000000000000,3,784,1,33.3333015,784,1,33.3333015,3002,4320
3075,4.000000000000000,0.000277777777778,79,2219,2140,750.500000000000000,855.162119132974681,3002.000000000000000,4,79,1,25.0000000,79,1,25.0000000,342,2219
3076,4.000000000000000,0.000277777777778,108,1173,1065,759.250000000000000,427.541445359394345,3037.000000000000000,4,108,1,25.0000000,108,1,25.0000000,646,1173
3077,4.000000000000000,0.000277777777778,5,3503,3498,1151.500000000000000,1375.730624068534780,4606.000000000000000,4,5,1,25.0000000,5,1,25.0000000,533,3503
3078,4.000000000000000,0.000277777777778,370,1407,1037,987.250000000000000,382.822658028492356,3949.000000000000000,4,370,1,25.0000000,370,1,25.0000000,1017,1407
3079,4.000000000000000,0.000277777777778,725,2264,1539,1115.750000000000000,662.960924564940001,4463.000000000000000,4,725,1,25.0000000,725,1,25.0000000,736,2264
3080,4.000000000000000,0.000277777777778,701,1283,582,1021.250000000000000,225.164800757134316,4085.000000000000000,4,701,1,25.0000000,701,1,25.0000000,928,1283
3081,4.000000000000000,0.000277777777778,823,4139,3316,2103.250000000000000,1328.659921688014265,8413.000000000000000,4,823,1,25.0000000,823,1,25.0000000,1021,4139
3082,4.000000000000000,0.000277777777778,80,2692,2612,843.750000000000000,1071.353903945843740,3375.000000000000000,4,80,1,25.0000000,80,1,25.0000000,258,2692
3083,4.000000000000000,0.000277777777778,230,3393,3163,1781.250000000000000,1541.585608229396939,7125.000000000000000,4,230,1,25.0000000,230,1,25.0000000,251,3393
3084,4.000000000000000,0.000277777777778,251,3393,3142,1814.500000000000000,1508.855443705592279,7258.000000000000000,4,251,1,25.0000000,251,1,25.0000000,363,3393
3085,4.000000000000000,0.000277777777778,86,387,301,235.250000000000000,122.927570137866141,941.000000000000000,4,86,1,25.0000000,86,1,25.0000000,147,387
3086,5.000000000000000,0.000347222222222,688,2513,1825,1455.599999999999909,766.704271541511616,7278.000000000000000,5,688,1,20.0000000,688,1,20.0000000,1037,2513
3087,4.000000000000000,0.000277777777778,688,2513,1825,1512.750000000000000,706.611765752594806,6051.000000000000000,4,688,1,25.0000000,688,1,25.0000000,1037,2513
3088,5.000000000000000,0.000347222222222,688,2513,1825,1610.799999999999955,744.479791532315517,8054.000000000000000,5,688,1,20.0000000,688,1,20.0000000,1813,2513
3089,4.000000000000000,0.000277777777778,146,1949,1803,857.250000000000114,758.052892283909273,3429.000000000000000,4,146,1,25.0000000,146,1,25.0000000,153,1949
3090,4.000000000000000,0.000277777777778,739,1367,628,1032.750000000000000,227.857822994954489,4131.000000000000000,4,739,1,25.0000000,739,1,25.0000000,946,1367
3091,4.000000000000000,0.000277777777778,488,1484,996,1104.500000000000000,385.243105064840847,4418.000000000000000,4,488,1,25.0000000,488,1,25.0000000,1079,1484
3092,4.000000000000000,0.000277777777778,488,1484,996,1104.500000000000000,385.243105064840847,4418.000000000000000,4,488,1,25.0000000,488,1,25.0000000,1079,1484
3093,4.000000000000000,0.000277777777778,150,2000,1850,830.000000000000000,716.978381821934704,3320.000000000000000,4,150,1,25.0000000,150,1,25.0000000,356,2000
3094,4.000000000000000,0.000277777777778,434,1351,917,788.750000000000000,372.810524931901625,3155.000000000000000,4,434,1,25.0000000,434,1,25.0000000,470,1351
3095,4.000000000000000,0.000277777777778,817,4803,3986,2161.750000000000000,1557.483767973201111,8647.000000000000000,4,817,1,25.0000000,817,1,25.0000000,1316,4803
3096,4.000000000000000,0.000277777777778,817,4803,3986,2161.750000000000000,1557.483767973201111,8647.000000000000000,4,817,1,25.0000000,817,1,25.0000000,1316,4803
3097,4.000000000000000,0.000277777777778,639,4664,4025,2650.750000000000000,1610.690282922201050,10603.000000000000000,4,639,1,25.0000000,639,1,25.0000000,1583,4664
3098,4.000000000000000,0.000277777777778,57,4122,4065,1329.750000000000000,1629.391354923671997,5319.000000000000000,4,57,1,25.0000000,57,1,25.0000000,414,4122
3099,4.000000000000000,0.000277777777778,267,3391,3124,1434.250000000000000,1175.763448785511400,5737.000000000000000,4,267,1,25.0000000,267,1,25.0000000,924,3391
3100,4.000000000000000,0.000277777777778,180,507,327,348.250000000000000,137.101012031275673,1393.000000000000000,4,180,1,25.0000000,180,1,25.0000000,249,507
3101,4.000000000000000,0.000277777777778,660,2502,1842,1394.500000000000000,737.410842068381839,5578.000000000000000,4,660,1,25.0000000,660,1,25.0000000,796,2502
3102,4.000000000000000,0.000277777777778,796,2502,1706,1622.750000000000000,632.670283402026030,6491.000000000000000,4,796,1,25.0000000,796,1,25.0000000,1329,2502
3103,4.000000000000000,0.000277777777778,796,2502,1706,1682.000000000000000,607.787791914250306,6728.000000000000000,4,796,1,25.0000000,796,1,25.0000000,1620,2502
3104,4.000000000000000,0.000277777777778,358,2616,2258,1132.000000000000000,883.020951053824092,4528.000000000000000,4,358,1,25.0000000,358,1,25.0000000,596,2616
3105,4.000000000000000,0.000277777777778,217,2616,2399,946.750000000000000,973.214101572721802,3787.000000000000000,4,217,1,25.0000000,217,1,25.0000000,358,2616
3106,6.000000000000000,0.000416666666667,270,4005,3735,1449.833333333333485,1209.091176141080723,8699.000000000000000,6,270,1,16.6667004,270,1,16.6667004,844,1498
3107,4.000000000000000,0.000277777777778,266,2056,1790,853.749999999999886,703.900694345445345,3415.000000000000000,4,266,1,25.0000000,266,1,25.0000000,513,2056
3108,4.000000000000000,0.000277777777778,513,1946,1433,1204.750000000000000,661.285632310274877,4819.000000000000000,4,513,1,25.0000000,513,1,25.0000000,580,1946
3109,3.000000000000000,0.000208333333333,513,2056,1543,1049.666666666666515,712.110634350839860,3149.000000000000000,3,513,1,33.3333015,513,1,33.3333015,580,2056
3110,4.000000000000000,0.000277777777778,475,854,379,640.000000000000000,167.357401987483058,2560.000000000000000,4,475,1,25.0000000,475,1,25.0000000,478,854
3111,4.000000000000000,0.000277777777778,502,993,491,725.500000000000000,175.000714284256560,2902.000000000000000,4,502,1,25.0000000,502,1,25.0000000,700,993
3112,4.000000000000000,0.000277777777778,386,1100,714,883.500000000000000,290.807926301880570,3534.000000000000000,4,386,1,25.0000000,386,1,25.0000000,977,1100
3113,4.000000000000000,0.000277777777778,386,1100,714,883.500000000000000,290.807926301880570,3534.000000000000000,4,386,1,25.0000000,386,1,25.0000000,977,1100
3114,4.000000000000000,0.000277777777778,386,1100,714,883.500000000000000,290.807926301880570,3534.000000000000000,4,386,1,25.0000000,386,1,25.0000000,977,1100
3115,4.000000000000000,0.000277777777778,973,2431,1458,1952.500000000000000,573.720533012371789,7810.000000000000000,4,973,1,25.0000000,973,1,25.0000000,2166,2431
3116,4.000000000000000,0.000277777777778,609,1950,1341,1090.000000000000000,528.782091224731289,4360.000000000000000,4,609,1,25.0000000,609,1,25.0000000,706,1950
3117,3.000000000000000,0.000208333333333,609,1095,486,803.333333333333371,210.006878194236492,2410.000000000000000,3,609,1,33.3333015,609,1,33.3333015,706,1095
3118,5.000000000000000,0.000347222222222,0,1095,1095,482.000000000000000,425.845511893691310,2410.000000000000000,4,0,2,40.0000000,609,1,20.0000000,609,1095
3119,3.000000000000000,0.000208333333333,609,1095,486,803.333333333333371,210.006878194236492,2410.000000000000000,3,609,1,33.3333015,609,1,33.3333015,706,1095
3120,4.000000000000000,0.000277777777778,0,1768,1768,868.000000000000114,648.466267434166639,3472.000000000000000,4,0,1,25.0000000,0,1,25.0000000,609,1768
3121,5.000000000000000,0.000347222222222,113,3017,2904,1074.400000000000091,1008.416501253326373,5372.000000000000000,5,113,1,20.0000000,113,1,20.0000000,789,3017
3122,4.000000000000000,0.000277777777778,209,696,487,523.750000000000000,186.641869632727349,2095.000000000000000,4,209,1,25.0000000,209,1,25.0000000,580,696
3123,4.000000000000000,0.000277777777778,580,928,348,703.500000000000000,136.428552729991253,2814.000000000000000,4,580,1,25.0000000,580,1,25.0000000,610,928
3124,4.000000000000000,0.000277777777778,334,2947,2613,1117.750000000000000,1061.532471241459461,4471.000000000000000,4,334,1,25.0000000,334,1,25.0000000,580,2947
3125,3.000000000000000,0.000208333333333,218,856,638,432.333333333333371,299.584527118622873,1297.000000000000000,3,218,1,33.3333015,218,1,33.3333015,223,856
3126,3.000000000000000,0.000208333333333,193,2157,1964,1408.000000000000000,866.868309875650425,4224.000000000000000,3,193,1,33.3333015,193,1,33.3333015,1874,2157
3127,4.000000000000000,0.000277777777778,748,2186,1438,1316.250000000000000,556.889744473715382,5265.000000000000000,4,748,1,25.0000000,748,1,25.0000000,925,2186
3128,4.000000000000000,0.000277777777778,711,8404,7693,2768.750000000000000,3255.403152836834579,11075.000000000000000,4,711,1,25.0000000,711,1,25.0000000,958,8404
3129,4.000000000000000,0.000277777777778,374,2856,2482,1372.750000000000000,910.689676838383889,5491.000000000000000,4,374,1,25.0000000,374,1,25.0000000,1095,2856
3130,3.000000000000000,0.000208333333333,280,851,571,602.666666666666629,238.962107642381028,1808.000000000000000,3,280,1,33.3333015,280,1,33.3333015,677,851
3131,4.000000000000000,0.000277777777778,612,3670,3058,1460.000000000000000,1282.276686210897196,5840.000000000000000,4,612,1,25.0000000,612,1,25.0000000,627,3670
3132,3.000000000000000,0.000208333333333,612,729,117,678.000000000000000,48.928519290900269,2034.000000000000000,3,612,1,33.3333015,612,1,33.3333015,693,729
3133,4.000000000000000,0.000277777777778,1619,3047,1428,2209.750000000000000,531.797600126213410,8839.000000000000000,4,1619,1,25.0000000,1619,1,25.0000000,1927,3047
3134,3.000000000000000,0.000208333333333,1619,3047,1428,2197.666666666666515,613.591250118694461,6593.000000000000000,3,1619,1,33.3333015,1619,1,33.3333015,1927,3047
3135,4.000000000000000,0.000277777777778,962,8038,7076,2760.500000000000000,3047.082251925602577,11042.000000000000000,4,962,1,25.0000000,962,1,25.0000000,1005,8038
3136,3.000000000000000,0.000208333333333,962,8038,7076,3335.000000000000000,3325.569525159061413,10005.000000000000000,3,962,1,33.3333015,962,1,33.3333015,1005,8038
3137,4.000000000000000,0.000277777777778,712,1037,325,929.000000000000000,128.080053091806604,3716.000000000000000,4,712,1,25.0000000,712,1,25.0000000,962,1037
3138,5.000000000000000,0.000347222222222,124,893,769,442.000000000000000,345.638539517803224,2210.000000000000000,5,124,1,20.0000000,124,1,20.0000000,182,893
3139,4.000000000000000,0.000277777777778,28,588,560,343.250000000000000,201.329797844233667,1373.000000000000000,4,28,1,25.0000000,28,1,25.0000000,365,588
3140,3.000000000000000,0.000208333333333,94,1607,1513,665.666666666666629,670.712225092765834,1997.000000000000000,3,94,1,33.3333015,94,1,33.3333015,296,1607
3141,4.000000000000000,0.000277777777778,154,969,815,723.250000000000000,331.969407476050435,2893.000000000000000,4,154,1,25.0000000,154,1,25.0000000,840,969
3142,4.000000000000000,0.000277777777778,75,1064,989,551.000000000000000,368.086267062491743,2204.000000000000000,4,75,1,25.0000000,75,1,25.0000000,372,1064
3143,4.000000000000000,0.000277777777778,743,1017,274,922.250000000000000,109.136096228516450,3689.000000000000000,4,743,1,25.0000000,743,1,25.0000000,926,1017
3144,4.000000000000000,0.000277777777778,743,1017,274,922.250000000000000,109.136096228516450,3689.000000000000000,4,743,1,25.0000000,743,1,25.0000000,926,1017
3145,4.000000000000000,0.000277777777778,687,1753,1066,1072.000000000000000,417.340388651757507,4288.000000000000000,4,687,1,25.0000000,687,1,25.0000000,781,1753
3146,5.000000000000000,0.000347222222222,632,1638,1006,902.000000000000000,372.334795580536650,4510.000000000000000,5,632,1,20.0000000,632,1,20.0000000,762,1638
3147,4.000000000000000,0.000277777777778,573,4994,4421,2412.250000000000000,1623.810237527772188,9649.000000000000000,4,573,1,25.0000000,573,1,25.0000000,1707,4994
3148,3.000000000000000,0.000208333333333,101,2056,1955,1160.666666666666742,806.540072711138691,3482.000000000000000,3,101,1,33.3333015,101,1,33.3333015,1325,2056
3149,4.000000000000000,0.000277777777778,101,2056,1955,1282.000000000000000,729.414491218813168,5128.000000000000000,4,101,1,25.0000000,101,1,25.0000000,1325,2056
3150,4.000000000000000,0.000277777777778,561,1112,551,883.750000000000000,203.309339431320751,3535.000000000000000,4,561,1,25.0000000,561,1,25.0000000,883,1112
3151,4.000000000000000,0.000277777777778,557,2751,2194,1765.250000000000000,852.163239937043954,7061.000000000000000,4,557,1,25.0000000,557,1,25.0000000,1403,2751
3152,4.000000000000000,0.000277777777778,165,3911,3746,1990.000000000000000,1682.977421120081544,7960.000000000000000,4,165,1,25.0000000,165,1,25.0000000,475,3911
3153,6.000000000000000,0.000416666666667,899,1723,824,1321.333333333333258,283.021004324571095,7928.000000000000000,6,899,1,16.6667004,899,1,16.6667004,1198,1623
3154,4.000000000000000,0.000277777777778,899,1623,724,1267.000000000000000,261.477532495623791,5068.000000000000000,4,899,1,25.0000000,899,1,25.0000000,1198,1623
3155,4.000000000000000,0.000277777777778,899,1723,824,1292.000000000000000,296.724619807659394,5168.000000000000000,4,899,1,25.0000000,899,1,25.0000000,1198,1723
3156,4.000000000000000,0.000277777777778,120,2067,1947,630.000000000000000,829.961746106409464,2520.000000000000000,4,120,1,25.0000000,120,1,25.0000000,149,2067
3157,4.000000000000000,0.000277777777778,415,1487,1072,690.500000000000000,459.954617326535811,2762.000000000000000,4,415,1,25.0000000,415,1,25.0000000,420,1487
3158,4.000000000000000,0.000277777777778,853,2131,1278,1617.500000000000000,492.539592317206541,6470.000000000000000,4,853,1,25.0000000,853,1,25.0000000,1530,2131
3159,3.000000000000000,0.000208333333333,636,4015,3379,2161.333333333333485,1398.871529324818312,6484.000000000000000,3,636,1,33.3333015,636,1,33.3333015,1833,4015
3160,4.000000000000000,0.000277777777778,636,4015,3379,2136.500000000000000,1212.221617527092349,8546.000000000000000,4,636,1,25.0000000,636,1,25.0000000,1833,4015
3161,4.000000000000000,0.000277777777778,96,2901,2805,1167.750000000000000,1050.094608832937411,4671.000000000000000,4,96,1,25.0000000,96,1,25.0000000,697,2901
3162,4.000000000000000,0.000277777777778,794,4565,3771,1821.250000000000000,1585.721503764138333,7285.000000000000000,4,794,1,25.0000000,794,1,25.0000000,936,4565
3163,4.000000000000000,0.000277777777778,794,4565,3771,1821.250000000000000,1585.721503764138333,7285.000000000000000,4,794,1,25.0000000,794,1,25.0000000,936,4565
3164,4.000000000000000,0.000277777777778,235,784,549,591.000000000000000,214.143643379858474,2364.000000000000000,4,235,1,25.0000000,235,1,25.0000000,617,784
3165,4.000000000000000,0.000277777777778,557,2810,2253,1246.250000000000000,920.387520286971267,4985.000000000000000,4,557,1,25.0000000,557,1,25.0000000,602,2810
3166,4.000000000000000,0.000277777777778,171,1183,1012,453.000000000000000,422.628087093132024,1812.000000000000000,4,171,1,25.0000000,171,1,25.0000000,200,1183
3167,4.000000000000000,0.000277777777778,171,1183,1012,453.000000000000000,422.628087093132024,1812.000000000000000,4,171,1,25.0000000,171,1,25.0000000,200,1183
3168,4.000000000000000,0.000277777777778,74,1183,1109,421.499999999999943,444.443753471685113,1686.000000000000000,4,74,1,25.0000000,74,1,25.0000000,171,1183
3169,5.000000000000000,0.000347222222222,74,1183,1109,449.199999999999989,401.364373107529332,2246.000000000000000,5,74,1,20.0000000,74,1,20.0000000,258,1183
3170,4.000000000000000,0.000277777777778,998,1964,966,1318.750000000000000,385.539475929508399,5275.000000000000000,4,998,1,25.0000000,998,1,25.0000000,1050,1964
3171,4.000000000000000,0.000277777777778,961,1635,674,1307.500000000000000,256.617906623836348,5230.000000000000000,4,961,1,25.0000000,961,1,25.0000000,1183,1635
3172,4.000000000000000,0.000277777777778,748,4824,4076,2096.750000000000000,1639.124061046021097,8387.000000000000000,4,748,1,25.0000000,748,1,25.0000000,888,4824
3173,4.000000000000000,0.000277777777778,423,1871,1448,1282.000000000000000,535.980410089771794,5128.000000000000000,4,423,1,25.0000000,423,1,25.0000000,1299,1871
3174,4.000000000000000,0.000277777777778,2261,4450,2189,3765.250000000000000,878.967967277533944,15061.000000000000000,4,2261,1,25.0000000,2261,1,25.0000000,4068,4450
3175,5.000000000000000,0.000347222222222,2261,4450,2189,3773.599999999999909,786.350201882087617,18868.000000000000000,5,2261,1,20.0000000,2261,1,20.0000000,4068,4450
3176,4.000000000000000,0.000277777777778,2261,4282,2021,3604.500000000000000,793.699722817136944,14418.000000000000000,4,2261,1,25.0000000,2261,1,25.0000000,3807,4282
3177,4.000000000000000,0.000277777777778,1666,4450,2784,3111.250000000000000,1174.658966466437960,12445.000000000000000,4,1666,1,25.0000000,1666,1,25.0000000,2261,4450
3178,4.000000000000000,0.000277777777778,1666,4450,2784,3111.250000000000000,1174.658966466437960,12445.000000000000000,4,1666,1,25.0000000,1666,1,25.0000000,2261,4450
3179,5.000000000000000,0.000347222222222,124,893,769,442.000000000000000,345.638539517803224,2210.000000000000000,5,124,1,20.0000000,124,1,20.0000000,182,893
3180,4.000000000000000,0.000277777777778,566,2845,2279,1260.750000000000000,924.247092232374825,5043.000000000000000,4,566,1,25.0000000,566,1,25.0000000,696,2845
3181,4.000000000000000,0.000277777777778,1418,1523,105,1467.500000000000000,39.246018906380812,5870.000000000000000,4,1418,1,25.0000000,1418,1,25.0000000,1447,1523
3182,4.000000000000000,0.000277777777778,651,1294,643,869.000000000000000,254.174152895214746,3476.000000000000000,4,651,1,25.0000000,651,1,25.0000000,699,1294
3183,4.000000000000000,0.000277777777778,117,943,826,633.000000000000000,309.899983865762749,2532.000000000000000,4,117,1,25.0000000,117,1,25.0000000,719,943
3184,3.000000000000000,0.000208333333333,573,608,35,591.333333333333371,14.337208778404378,1774.000000000000000,3,573,1,33.3333015,573,1,33.3333015,593,608
3185,4.000000000000000,0.000277777777778,620,1316,696,947.750000000000000,266.942292452882043,3791.000000000000000,4,620,1,25.0000000,620,1,25.0000000,784,1316
3186,4.000000000000000,0.000277777777778,213,921,708,640.500000000000000,261.021550834409084,2562.000000000000000,4,213,1,25.0000000,213,1,25.0000000,702,921
3187,3.000000000000000,0.000208333333333,213,1871,1658,1001.666666666666742,679.274776671578024,3005.000000000000000,3,213,1,33.3333015,213,1,33.3333015,921,1871
3188,4.000000000000000,0.000277777777778,213,1871,1658,891.750000000000000,618.308731541129077,3567.000000000000000,4,213,1,25.0000000,213,1,25.0000000,562,1871
3189,5.000000000000000,0.000347222222222,274,3192,2918,1507.000000000000000,1021.045346691321015,7535.000000000000000,5,274,1,20.0000000,274,1,20.0000000,1362,3192
3190,4.000000000000000,0.000277777777778,39,1218,1179,393.750000000000000,485.022873171977324,1575.000000000000000,4,39,1,25.0000000,39,1,25.0000000,46,1218
3191,4.000000000000000,0.000277777777778,70,980,910,450.750000000000000,373.042474123255829,1803.000000000000000,4,70,1,25.0000000,70,1,25.0000000,131,980
3192,4.000000000000000,0.000277777777778,613,1977,1364,1372.500000000000000,488.958331558017335,5490.000000000000000,4,613,1,25.0000000,613,1,25.0000000,1418,1977
3193,4.000000000000000,0.000277777777778,304,1152,848,758.750000000000000,301.515650505906592,3035.000000000000000,4,304,1,25.0000000,304,1,25.0000000,777,1152
3194,4.000000000000000,0.000277777777778,511,9451,8940,3989.500000000000000,3312.635544396636760,15958.000000000000000,4,511,1,25.0000000,511,1,25.0000000,2990,9451
3195,4.000000000000000,0.000277777777778,511,9451,8940,3989.500000000000000,3312.635544396636760,15958.000000000000000,4,511,1,25.0000000,511,1,25.0000000,2990,9451
3196,5.000000000000000,0.000347222222222,374,9451,9077,3266.400000000000091,3297.019538916928923,16332.000000000000000,5,374,1,20.0000000,374,1,20.0000000,2990,9451
3197,5.000000000000000,0.000347222222222,749,1717,968,1157.400000000000091,316.398862197701362,5787.000000000000000,5,749,1,20.0000000,749,1,20.0000000,1092,1717
3198,4.000000000000000,0.000277777777778,861,5002,4141,1919.000000000000000,1780.068116674190833,7676.000000000000000,4,861,1,25.0000000,861,1,25.0000000,905,5002
3199,4.000000000000000,0.000277777777778,63,1182,1119,608.750000000000000,424.562937030542059,2435.000000000000000,4,63,1,25.0000000,63,1,25.0000000,378,1182
3200,4.000000000000000,0.000277777777778,392,969,577,743.000000000000000,229.744423218497303,2972.000000000000000,4,392,1,25.0000000,392,1,25.0000000,685,969
3201,4.000000000000000,0.000277777777778,373,2095,1722,1286.250000000000000,714.434522892056179,5145.000000000000000,4,373,1,25.0000000,373,1,25.0000000,815,2095
3202,4.000000000000000,0.000277777777778,1000,1670,670,1389.000000000000000,290.803198056692622,5556.000000000000000,4,1000,1,25.0000000,1000,1,25.0000000,1217,1670
3203,3.000000000000000,0.000208333333333,468,2779,2311,1637.000000000000000,943.654951063505337,4911.000000000000000,3,468,1,33.3333015,468,1,33.3333015,1664,2779
3204,4.000000000000000,0.000277777777778,590,1386,796,920.000000000000000,300.163288894561560,3680.000000000000000,4,590,1,25.0000000,590,1,25.0000000,740,1386
3205,4.000000000000000,0.000277777777778,73,2012,1939,862.250000000000000,788.989979340675745,3449.000000000000000,4,73,1,25.0000000,73,1,25.0000000,192,2012
3206,4.000000000000000,0.000277777777778,192,1224,1032,679.250000000000000,427.530919934453436,2717.000000000000000,4,192,1,25.0000000,192,1,25.0000000,338,1224
3207,5.000000000000000,0.000347222222222,980,1862,882,1421.000000000000000,315.450788555045449,7105.000000000000000,5,980,1,20.0000000,980,1,20.0000000,1343,1862
3208,4.000000000000000,0.000277777777778,52,465,413,226.250000000000000,156.862001453506906,905.000000000000000,4,52,1,25.0000000,52,1,25.0000000,127,465
3209,4.000000000000000,0.000277777777778,52,465,413,226.250000000000000,156.862001453506906,905.000000000000000,4,52,1,25.0000000,52,1,25.0000000,127,465
3210,4.000000000000000,0.000277777777778,642,1046,404,922.250000000000000,163.034313872877703,3689.000000000000000,4,642,1,25.0000000,642,1,25.0000000,990,1046
3211,4.000000000000000,0.000277777777778,315,1243,928,809.500000000000000,333.314791150947883,3238.000000000000000,4,315,1,25.0000000,315,1,25.0000000,769,1243
3212,4.000000000000000,0.000277777777778,609,1950,1341,1355.500000000000000,535.889214297134345,5422.000000000000000,4,609,1,25.0000000,609,1,25.0000000,1095,1950
3213,5.000000000000000,0.000347222222222,726,7336,6610,2373.800000000000182,2494.468632795369558,11869.000000000000000,5,726,1,20.0000000,726,1,20.0000000,1355,7336
3214,5.000000000000000,0.000347222222222,726,7336,6610,2373.800000000000182,2494.468632795369558,11869.000000000000000,5,726,1,20.0000000,726,1,20.0000000,1355,7336
3215,4.000000000000000,0.000277777777778,0,3174,3174,899.750000000000000,1323.978167304884209,3599.000000000000000,4,0,1,25.0000000,0,1,25.0000000,6,3174
3216,3.000000000000000,0.000208333333333,395,2434,2039,1158.666666666666742,907.646162089365930,3476.000000000000000,3,395,1,33.3333015,395,1,33.3333015,647,2434
3217,4.000000000000000,0.000277777777778,386,1100,714,883.500000000000000,290.807926301880570,3534.000000000000000,4,386,1,25.0000000,386,1,25.0000000,977,1100
3218,4.000000000000000,0.000277777777778,386,1100,714,883.500000000000000,290.807926301880570,3534.000000000000000,4,386,1,25.0000000,386,1,25.0000000,977,1100
3219,4.000000000000000,0.000277777777778,92,1067,975,608.500000000000000,360.506934746060097,2434.000000000000000,4,92,1,25.0000000,92,1,25.0000000,494,1067
3220,4.000000000000000,0.000277777777778,1184,2693,1509,2046.500000000000000,545.646634737171325,8186.000000000000000,4,1184,1,25.0000000,1184,1,25.0000000,2101,2693
3221,4.000000000000000,0.000277777777778,511,4607,4096,2111.000000000000000,1631.459622546632318,8444.000000000000000,4,511,1,25.0000000,511,1,25.0000000,810,4607
3222,3.000000000000000,0.000208333333333,689,2029,1340,1559.333333333333258,616.062947721704404,4678.000000000000000,3,689,1,33.3333015,689,1,33.3333015,1960,2029
3223,4.000000000000000,0.000277777777778,311,1773,1462,782.000000000000000,583.901532794699847,3128.000000000000000,4,311,1,25.0000000,311,1,25.0000000,411,1773
3224,3.000000000000000,0.000208333333333,653,3834,3181,2632.000000000000000,1410.079666780095977,7896.000000000000000,3,653,1,33.3333015,653,1,33.3333015,3409,3834
3225,4.000000000000000,0.000277777777778,537,1045,508,773.500000000000000,204.480439162282721,3094.000000000000000,4,537,1,25.0000000,537,1,25.0000000,620,1045
3226,3.000000000000000,0.000208333333333,936,1648,712,1235.333333333333258,301.517642748959020,3706.000000000000000,3,936,1,33.3333015,936,1,33.3333015,1122,1648
3227,4.000000000000000,0.000277777777778,936,1648,712,1306.500000000000000,288.753787853943152,5226.000000000000000,4,936,1,25.0000000,936,1,25.0000000,1122,1648
3228,4.000000000000000,0.000277777777778,112,848,736,570.000000000000000,301.291387198505902,2280.000000000000000,4,112,1,25.0000000,112,1,25.0000000,487,848
3229,4.000000000000000,0.000277777777778,112,848,736,570.000000000000000,301.291387198505902,2280.000000000000000,4,112,1,25.0000000,112,1,25.0000000,487,848
3230,4.000000000000000,0.000277777777778,856,1376,520,1010.750000000000000,214.167428662717072,4043.000000000000000,4,856,1,25.0000000,856,1,25.0000000,861,1376
3231,4.000000000000000,0.000277777777778,362,1608,1246,1092.500000000000000,458.825947391818715,4370.000000000000000,4,362,1,25.0000000,362,1,25.0000000,1101,1608
3232,5.000000000000000,0.000347222222222,362,1608,1246,1077.400000000000091,411.496099616995139,5387.000000000000000,5,362,1,20.0000000,362,1,20.0000000,1101,1608
3233,4.000000000000000,0.000277777777778,376,2166,1790,1278.000000000000000,670.248834389139347,5112.000000000000000,4,376,1,25.0000000,376,1,25.0000000,973,2166
3234,3.000000000000000,0.000208333333333,894,977,83,921.666666666666629,39.126575225655628,2765.000000000000000,2,894,2,66.6667023,977,1,33.3333015,894,977
3235,4.000000000000000,0.000277777777778,849,977,128,903.500000000000000,46.241215381951193,3614.000000000000000,3,894,2,50.0000000,849,1,25.0000000,894,977
3236,4.000000000000000,0.000277777777778,348,1342,994,771.750000000000000,423.406645554837780,3087.000000000000000,4,348,1,25.0000000,348,1,25.0000000,381,1342
3237,4.000000000000000,0.000277777777778,670,1058,388,848.250000000000000,174.330684332965319,3393.000000000000000,4,670,1,25.0000000,670,1,25.0000000,682,1058
3238,4.000000000000000,0.000277777777778,172,1570,1398,758.750000000000000,589.789528136944796,3035.000000000000000,4,172,1,25.0000000,172,1,25.0000000,220,1570
3239,4.000000000000000,0.000277777777778,85,2491,2406,1253.250000000000000,963.004770237406433,5013.000000000000000,4,85,1,25.0000000,85,1,25.0000000,582,2491
3240,4.000000000000000,0.000277777777778,676,2841,2165,1613.750000000000000,842.025942296316657,6455.000000000000000,4,676,1,25.0000000,676,1,25.0000000,1017,2841
3241,4.000000000000000,0.000277777777778,75,1263,1188,732.500000000000000,430.992749358965455,2930.000000000000000,4,75,1,25.0000000,75,1,25.0000000,693,1263
3242,4.000000000000000,0.000277777777778,699,1286,587,985.250000000000000,236.821003080385594,3941.000000000000000,4,699,1,25.0000000,699,1,25.0000000,817,1286
3243,4.000000000000000,0.000277777777778,730,1703,973,1412.250000000000000,395.878374630390795,5649.000000000000000,4,730,1,25.0000000,730,1,25.0000000,1597,1703
3244,4.000000000000000,0.000277777777778,730,1703,973,1412.250000000000000,395.878374630390795,5649.000000000000000,4,730,1,25.0000000,730,1,25.0000000,1597,1703
3245,4.000000000000000,0.000277777777778,719,7847,7128,2860.750000000000000,2893.856283145380985,11443.000000000000000,4,719,1,25.0000000,719,1,25.0000000,1405,7847
3246,4.000000000000000,0.000277777777778,719,7847,7128,2860.750000000000000,2893.856283145380985,11443.000000000000000,4,719,1,25.0000000,719,1,25.0000000,1405,7847
3247,4.000000000000000,0.000277777777778,496,1010,514,652.500000000000000,207.868347758863962,2610.000000000000000,4,496,1,25.0000000,496,1,25.0000000,539,1010
3248,4.000000000000000,0.000277777777778,36,4160,4124,1351.000000000000000,1638.280501013181265,5404.000000000000000,4,36,1,25.0000000,36,1,25.0000000,596,4160
3249,4.000000000000000,0.000277777777778,880,1620,740,1098.750000000000000,305.520355295682407,4395.000000000000000,4,880,1,25.0000000,880,1,25.0000000,884,1620
3250,4.000000000000000,0.000277777777778,588,1348,760,1038.500000000000000,278.025628315088966,4154.000000000000000,4,588,1,25.0000000,588,1,25.0000000,1093,1348
3251,4.000000000000000,0.000277777777778,93,1353,1260,506.250000000000000,507.928821292905184,2025.000000000000000,4,93,1,25.0000000,93,1,25.0000000,131,1353
3252,4.000000000000000,0.000277777777778,312,2747,2435,1026.750000000000000,999.556245290879019,4107.000000000000000,4,312,1,25.0000000,312,1,25.0000000,422,2747
3253,4.000000000000000,0.000277777777778,335,715,380,585.250000000000000,147.648865556088850,2341.000000000000000,4,335,1,25.0000000,335,1,25.0000000,630,715
3254,3.000000000000000,0.000208333333333,335,715,380,560.000000000000000,162.839389174323145,1680.000000000000000,3,335,1,33.3333015,335,1,33.3333015,630,715
3255,3.000000000000000,0.000208333333333,104,630,526,356.333333333333371,215.267791883092031,1069.000000000000000,3,104,1,33.3333015,104,1,33.3333015,335,630
3256,4.000000000000000,0.000277777777778,33,2434,2401,1195.000000000000000,850.046175216382039,4780.000000000000000,4,33,1,25.0000000,33,1,25.0000000,1125,2434
3257,4.000000000000000,0.000277777777778,749,2305,1556,1339.500000000000000,583.491859411937298,5358.000000000000000,4,749,1,25.0000000,749,1,25.0000000,1079,2305
3258,4.000000000000000,0.000277777777778,817,4803,3986,1916.500000000000000,1669.418686249797702,7666.000000000000000,4,817,1,25.0000000,817,1,25.0000000,951,4803
3259,4.000000000000000,0.000277777777778,206,1095,889,767.250000000000000,338.622485225065986,3069.000000000000000,4,206,1,25.0000000,206,1,25.0000000,817,1095
3260,4.000000000000000,0.000277777777778,206,1095,889,718.750000000000000,341.900844544145571,2875.000000000000000,4,206,1,25.0000000,206,1,25.0000000,623,1095
3261,4.000000000000000,0.000277777777778,206,1384,1178,909.000000000000000,434.797079107024331,3636.000000000000000,4,206,1,25.0000000,206,1,25.0000000,951,1384
3262,4.000000000000000,0.000277777777778,817,4803,3986,1916.500000000000000,1669.418686249797702,7666.000000000000000,4,817,1,25.0000000,817,1,25.0000000,951,4803
3263,3.000000000000000,0.000208333333333,87,9451,9364,3261.333333333333030,4377.236596555208052,9784.000000000000000,3,87,1,33.3333015,87,1,33.3333015,246,9451
3264,4.000000000000000,0.000277777777778,819,1172,353,942.000000000000000,143.242800866221557,3768.000000000000000,4,819,1,25.0000000,819,1,25.0000000,824,1172
3265,4.000000000000000,0.000277777777778,322,977,655,621.250000000000000,233.860401735736360,2485.000000000000000,4,322,1,25.0000000,322,1,25.0000000,570,977
3266,4.000000000000000,0.000277777777778,322,977,655,621.250000000000000,233.860401735736360,2485.000000000000000,4,322,1,25.0000000,322,1,25.0000000,570,977
3267,4.000000000000000,0.000277777777778,969,4357,3388,1892.750000000000000,1427.381934697227507,7571.000000000000000,4,969,1,25.0000000,969,1,25.0000000,986,4357
3268,4.000000000000000,0.000277777777778,69,614,545,353.000000000000000,194.078592327953572,1412.000000000000000,4,69,1,25.0000000,69,1,25.0000000,336,614
3269,4.000000000000000,0.000277777777778,399,527,128,490.750000000000000,53.143085156960915,1963.000000000000000,4,399,1,25.0000000,399,1,25.0000000,515,527
3270,4.000000000000000,0.000277777777778,399,673,274,527.250000000000000,97.299473277094378,2109.000000000000000,4,399,1,25.0000000,399,1,25.0000000,515,673
3271,6.000000000000000,0.000416666666667,399,673,274,514.000000000000000,84.750614550377563,3084.000000000000000,6,399,1,16.6667004,399,1,16.6667004,515,527
3272,4.000000000000000,0.000277777777778,0,2009,2009,901.250000000000000,913.002019439168635,3605.000000000000000,3,0,2,50.0000000,1596,1,25.0000000,0,2009
3273,4.000000000000000,0.000277777777778,1065,3964,2899,2022.250000000000000,1170.160539199643381,8089.000000000000000,4,1065,1,25.0000000,1065,1,25.0000000,1139,3964
3274,4.000000000000000,0.000277777777778,636,2459,1823,1747.500000000000000,679.684669534336308,6990.000000000000000,4,636,1,25.0000000,636,1,25.0000000,1833,2459
3275,4.000000000000000,0.000277777777778,636,4015,3379,2136.500000000000000,1212.221617527092349,8546.000000000000000,4,636,1,25.0000000,636,1,25.0000000,1833,4015
3276,4.000000000000000,0.000277777777778,251,1207,956,794.750000000000000,356.851772449009957,3179.000000000000000,4,251,1,25.0000000,251,1,25.0000000,728,1207
3277,4.000000000000000,0.000277777777778,678,943,265,800.000000000000000,95.386057681403315,3200.000000000000000,4,678,1,25.0000000,678,1,25.0000000,769,943
3278,4.000000000000000,0.000277777777778,221,1171,950,679.750000000000000,459.325252408356107,2719.000000000000000,3,221,2,50.0000000,1106,1,25.0000000,221,1171
3279,4.000000000000000,0.000277777777778,690,8322,7632,2823.000000000000000,3183.365985870930672,11292.000000000000000,4,690,1,25.0000000,690,1,25.0000000,938,8322
3280,4.000000000000000,0.000277777777778,769,1906,1137,1247.000000000000000,438.111287231908705,4988.000000000000000,4,769,1,25.0000000,769,1,25.0000000,946,1906
3281,3.000000000000000,0.000208333333333,946,1906,960,1406.333333333333258,392.904002977261030,4219.000000000000000,3,946,1,33.3333015,946,1,33.3333015,1367,1906
3282,4.000000000000000,0.000277777777778,739,1367,628,1032.750000000000000,227.857822994954489,4131.000000000000000,4,739,1,25.0000000,739,1,25.0000000,946,1367
3283,4.000000000000000,0.000277777777778,488,1367,879,970.000000000000000,317.171089476957206,3880.000000000000000,4,488,1,25.0000000,488,1,25.0000000,946,1367
3284,4.000000000000000,0.000277777777778,396,2297,1901,940.750000000000000,785.212192658774370,3763.000000000000000,4,396,1,25.0000000,396,1,25.0000000,515,2297
3285,6.000000000000000,0.000416666666667,484,3198,2714,1197.000000000000000,937.201508036914447,7182.000000000000000,6,484,1,16.6667004,484,1,16.6667004,710,1378
3286,4.000000000000000,0.000277777777778,484,3198,2714,1442.500000000000000,1065.506804295495840,5770.000000000000000,4,484,1,25.0000000,484,1,25.0000000,710,3198
3287,4.000000000000000,0.000277777777778,39,1162,1123,614.000000000000000,401.633539436138278,2456.000000000000000,4,39,1,25.0000000,39,1,25.0000000,544,1162
3288,4.000000000000000,0.000277777777778,642,1282,640,891.500000000000000,265.425601628780328,3566.000000000000000,4,642,1,25.0000000,642,1,25.0000000,652,1282
3289,4.000000000000000,0.000277777777778,636,2372,1736,1198.000000000000000,696.519920748861296,4792.000000000000000,4,636,1,25.0000000,636,1,25.0000000,720,2372
3290,4.000000000000000,0.000277777777778,749,2196,1447,1553.250000000000000,542.648309220622195,6213.000000000000000,4,749,1,25.0000000,749,1,25.0000000,1405,2196
3291,4.000000000000000,0.000277777777778,660,2890,2230,1561.000000000000000,886.014108239818029,6244.000000000000000,4,660,1,25.0000000,660,1,25.0000000,862,2890
3292,4.000000000000000,0.000277777777778,660,2890,2230,1561.000000000000000,886.014108239818029,6244.000000000000000,4,660,1,25.0000000,660,1,25.0000000,862,2890
3293,4.000000000000000,0.000277777777778,622,2017,1395,1306.000000000000000,591.156070763043090,5224.000000000000000,4,622,1,25.0000000,622,1,25.0000000,832,2017
3294,4.000000000000000,0.000277777777778,602,1044,442,828.250000000000000,161.738021194770397,3313.000000000000000,4,602,1,25.0000000,602,1,25.0000000,775,1044
3295,4.000000000000000,0.000277777777778,1162,2305,1143,1790.750000000000000,459.007829453921204,7163.000000000000000,4,1162,1,25.0000000,1162,1,25.0000000,1551,2305
3296,4.000000000000000,0.000277777777778,147,705,558,361.500000000000000,207.618038715329362,1446.000000000000000,4,147,1,25.0000000,147,1,25.0000000,290,705
3297,4.000000000000000,0.000277777777778,1944,3215,1271,2630.250000000000000,501.321939974703298,10521.000000000000000,4,1944,1,25.0000000,1944,1,25.0000000,2375,3215
3298,4.000000000000000,0.000277777777778,453,1488,1035,860.250000000000000,435.397160647609212,3441.000000000000000,4,453,1,25.0000000,453,1,25.0000000,455,1488
3299,5.000000000000000,0.000347222222222,530,1064,534,929.399999999999977,201.255658305549247,4647.000000000000000,5,530,1,20.0000000,530,1,20.0000000,1032,1064
3300,4.000000000000000,0.000277777777778,639,2287,1648,1125.500000000000000,674.771257538434270,4502.000000000000000,4,639,1,25.0000000,639,1,25.0000000,726,2287
3301,4.000000000000000,0.000277777777778,111,585,474,316.250000000000000,199.192588968565786,1265.000000000000000,4,111,1,25.0000000,111,1,25.0000000,139,585
3302,4.000000000000000,0.000277777777778,1586,2773,1187,2248.250000000000000,515.480055385268997,8993.000000000000000,4,1586,1,25.0000000,1586,1,25.0000000,1905,2773
3303,4.000000000000000,0.000277777777778,962,3416,2454,1616.250000000000000,1039.701008703944581,6465.000000000000000,4,962,1,25.0000000,962,1,25.0000000,1025,3416
3304,4.000000000000000,0.000277777777778,579,998,419,819.250000000000000,156.392734805680817,3277.000000000000000,4,579,1,25.0000000,579,1,25.0000000,794,998
3305,5.000000000000000,0.000347222222222,579,906,327,700.399999999999977,127.844593159038212,3502.000000000000000,5,579,1,20.0000000,579,1,20.0000000,620,906
3306,4.000000000000000,0.000277777777778,33,1114,1081,631.250000000000000,386.788298039121116,2525.000000000000000,4,33,1,25.0000000,33,1,25.0000000,669,1114
3307,4.000000000000000,0.000277777777778,4,161,157,84.750000000000000,60.532532575467222,339.000000000000000,4,4,1,25.0000000,4,1,25.0000000,53,161
3308,4.000000000000000,0.000277777777778,132,1254,1122,853.250000000000000,459.354642406060805,3413.000000000000000,4,132,1,25.0000000,132,1,25.0000000,777,1254
3309,3.000000000000000,0.000208333333333,1356,2464,1108,1953.000000000000000,456.408442808266500,5859.000000000000000,3,1356,1,33.3333015,1356,1,33.3333015,2039,2464
3310,4.000000000000000,0.000277777777778,185,762,577,464.000000000000000,271.264630941816677,1856.000000000000000,4,185,1,25.0000000,185,1,25.0000000,202,762
3311,3.000000000000000,0.000208333333333,168,1943,1775,764.666666666666742,833.229993592538676,2294.000000000000000,3,168,1,33.3333015,168,1,33.3333015,183,1943
3312,5.000000000000000,0.000347222222222,22,741,719,172.800000000000011,284.150945801698867,864.000000000000000,4,31,2,40.0000000,22,1,20.0000000,31,741
3313,4.000000000000000,0.000277777777778,669,1188,519,922.250000000000000,186.101282907990736,3689.000000000000000,4,669,1,25.0000000,669,1,25.0000000,873,1188
3314,4.000000000000000,0.000277777777778,455,899,444,678.250000000000000,199.671448885412758,2713.000000000000000,4,455,1,25.0000000,455,1,25.0000000,505,899
3315,4.000000000000000,0.000277777777778,455,899,444,678.250000000000000,199.671448885412758,2713.000000000000000,4,455,1,25.0000000,455,1,25.0000000,505,899
3316,4.000000000000000,0.000277777777778,292,3284,2992,1457.000000000000000,1119.075958101146853,5828.000000000000000,4,292,1,25.0000000,292,1,25.0000000,908,3284
3317,4.000000000000000,0.000277777777778,349,938,589,703.250000000000000,219.626245016391437,2813.000000000000000,4,349,1,25.0000000,349,1,25.0000000,712,938
3318,4.000000000000000,0.000277777777778,703,1902,1199,1303.750000000000000,539.530988452007250,5215.000000000000000,4,703,1,25.0000000,703,1,25.0000000,833,1902
3319,4.000000000000000,0.000277777777778,637,1885,1248,1046.750000000000000,493.552618775343944,4187.000000000000000,4,637,1,25.0000000,637,1,25.0000000,755,1885
3320,4.000000000000000,0.000277777777778,547,1681,1134,1224.750000000000000,424.724837394753706,4899.000000000000000,4,547,1,25.0000000,547,1,25.0000000,1214,1681
3321,4.000000000000000,0.000277777777778,654,2372,1718,1433.500000000000000,636.803541133370231,5734.000000000000000,4,654,1,25.0000000,654,1,25.0000000,1108,2372
3322,4.000000000000000,0.000277777777778,683,4578,3895,1691.750000000000000,1666.660639572435684,6767.000000000000000,4,683,1,25.0000000,683,1,25.0000000,737,4578
3323,4.000000000000000,0.000277777777778,683,4578,3895,1780.750000000000000,1623.967729821008561,7123.000000000000000,4,683,1,25.0000000,683,1,25.0000000,737,4578
3324,4.000000000000000,0.000277777777778,683,1125,442,823.750000000000000,175.731862506490245,3295.000000000000000,4,683,1,25.0000000,683,1,25.0000000,737,1125
3325,5.000000000000000,0.000347222222222,949,6378,5429,2397.000000000000000,2004.736690939735354,11985.000000000000000,5,949,1,20.0000000,949,1,20.0000000,1539,6378
3326,4.000000000000000,0.000277777777778,46,1590,1544,940.250000000000000,594.480603131843168,3761.000000000000000,4,46,1,25.0000000,46,1,25.0000000,778,1590
3327,3.000000000000000,0.000208333333333,1399,1680,281,1495.000000000000000,130.845965419903820,4485.000000000000000,3,1399,1,33.3333015,1399,1,33.3333015,1406,1680
3328,4.000000000000000,0.000277777777778,348,2066,1718,1119.500000000000000,617.340465221582576,4478.000000000000000,4,348,1,25.0000000,348,1,25.0000000,937,2066
3329,4.000000000000000,0.000277777777778,397,930,533,773.250000000000000,218.073812045371454,3093.000000000000000,3,883,2,50.0000000,397,1,25.0000000,883,930
3330,4.000000000000000,0.000277777777778,304,1152,848,758.750000000000000,301.515650505906592,3035.000000000000000,4,304,1,25.0000000,304,1,25.0000000,777,1152
3331,4.000000000000000,0.000277777777778,217,502,285,322.500000000000000,113.124930939205427,1290.000000000000000,4,217,1,25.0000000,217,1,25.0000000,235,502
3332,4.000000000000000,0.000277777777778,398,1202,804,865.000000000000000,346.229692545281296,3460.000000000000000,4,398,1,25.0000000,398,1,25.0000000,666,1202
3333,4.000000000000000,0.000277777777778,62,855,793,520.500000000000000,312.810245995875277,2082.000000000000000,4,62,1,25.0000000,62,1,25.0000000,407,855
3334,4.000000000000000,0.000277777777778,388,765,377,570.500000000000000,175.622464394507347,2282.000000000000000,4,388,1,25.0000000,388,1,25.0000000,403,765
3335,4.000000000000000,0.000277777777778,204,8996,8792,2640.000000000000000,3675.664021642892294,10560.000000000000000,4,204,1,25.0000000,204,1,25.0000000,566,8996
3336,4.000000000000000,0.000277777777778,778,1797,1019,1475.750000000000000,406.504228145292473,5903.000000000000000,4,778,1,25.0000000,778,1,25.0000000,1659,1797
3337,4.000000000000000,0.000277777777778,46,681,635,364.000000000000000,294.938129105071823,1456.000000000000000,4,46,1,25.0000000,46,1,25.0000000,94,681
3338,3.000000000000000,0.000208333333333,46,681,635,273.666666666666629,288.693994087549811,821.000000000000000,3,46,1,33.3333015,46,1,33.3333015,94,681
3339,4.000000000000000,0.000277777777778,340,3362,3022,1882.500000000000000,1442.093356894760745,7530.000000000000000,4,340,1,25.0000000,340,1,25.0000000,545,3362
3340,4.000000000000000,0.000277777777778,364,1006,642,808.500000000000000,261.863991415391069,3234.000000000000000,4,364,1,25.0000000,364,1,25.0000000,872,1006
3341,4.000000000000000,0.000277777777778,205,788,583,387.000000000000000,233.943369215714256,1548.000000000000000,4,205,1,25.0000000,205,1,25.0000000,255,788
3342,3.000000000000000,0.000208333333333,899,1623,724,1240.000000000000000,297.060038824926210,3720.000000000000000,3,899,1,33.3333015,899,1,33.3333015,1198,1623
3343,4.000000000000000,0.000277777777778,899,1623,724,1267.000000000000000,261.477532495623791,5068.000000000000000,4,899,1,25.0000000,899,1,25.0000000,1198,1623
3344,4.000000000000000,0.000277777777778,743,3690,2947,1507.250000000000000,1260.411515140987603,6029.000000000000000,4,743,1,25.0000000,743,1,25.0000000,797,3690
3345,3.000000000000000,0.000208333333333,562,1200,638,887.333333333333258,260.616363432707146,2662.000000000000000,3,562,1,33.3333015,562,1,33.3333015,900,1200
3346,4.000000000000000,0.000277777777778,258,817,559,546.250000000000000,223.147232785889599,2185.000000000000000,4,258,1,25.0000000,258,1,25.0000000,409,817
3347,4.000000000000000,0.000277777777778,1025,4074,3049,1932.000000000000000,1243.290593546014179,7728.000000000000000,4,1025,1,25.0000000,1025,1,25.0000000,1245,4074
3348,4.000000000000000,0.000277777777778,769,4074,3305,1813.000000000000000,1323.540894721428685,7252.000000000000000,4,769,1,25.0000000,769,1,25.0000000,1025,4074
3349,5.000000000000000,0.000347222222222,1230,2185,955,1567.599999999999909,331.893115324798543,7838.000000000000000,5,1230,1,20.0000000,1230,1,20.0000000,1530,2185
3350,4.000000000000000,0.000277777777778,801,3386,2585,1460.500000000000000,1111.741988952472639,5842.000000000000000,4,801,1,25.0000000,801,1,25.0000000,825,3386
3351,4.000000000000000,0.000277777777778,201,849,648,555.250000000000000,296.848761998429097,2221.000000000000000,3,849,2,50.0000000,201,1,25.0000000,322,849
3352,4.000000000000000,0.000277777777778,769,1384,615,980.250000000000000,242.459661593428763,3921.000000000000000,4,769,1,25.0000000,769,1,25.0000000,817,1384
3353,3.000000000000000,0.000208333333333,790,1310,520,1127.333333333333258,238.804429514101685,3382.000000000000000,3,790,1,33.3333015,790,1,33.3333015,1282,1310
3354,3.000000000000000,0.000208333333333,1144,1795,651,1400.333333333333258,283.198791585620199,4201.000000000000000,3,1144,1,33.3333015,1144,1,33.3333015,1262,1795
3355,3.000000000000000,0.000208333333333,1144,1795,651,1400.333333333333258,283.198791585620199,4201.000000000000000,3,1144,1,33.3333015,1144,1,33.3333015,1262,1795
3356,4.000000000000000,0.000277777777778,751,2466,1715,1247.250000000000000,705.809597200264761,4989.000000000000000,4,751,1,25.0000000,751,1,25.0000000,881,2466
3357,4.000000000000000,0.000277777777778,193,3311,3118,1590.250000000000000,1138.283219370293637,6361.000000000000000,4,193,1,25.0000000,193,1,25.0000000,1099,3311
3358,4.000000000000000,0.000277777777778,485,1167,682,788.500000000000000,256.991731384494130,3154.000000000000000,4,485,1,25.0000000,485,1,25.0000000,637,1167
3359,4.000000000000000,0.000277777777778,527,1222,695,725.500000000000000,287.548691528930476,2902.000000000000000,4,527,1,25.0000000,527,1,25.0000000,562,1222
3360,3.000000000000000,0.000208333333333,837,1723,886,1254.666666666666742,363.477952869527201,3764.000000000000000,3,837,1,33.3333015,837,1,33.3333015,1204,1723
3361,4.000000000000000,0.000277777777778,837,1723,886,1261.250000000000000,322.554162118550323,5045.000000000000000,4,837,1,25.0000000,837,1,25.0000000,1137,1723
3362,3.000000000000000,0.000208333333333,1231,1869,638,1538.333333333333258,260.984461010399798,4615.000000000000000,3,1231,1,33.3333015,1231,1,33.3333015,1515,1869
3363,4.000000000000000,0.000277777777778,430,5305,4875,2094.750000000000000,1987.406271374828748,8379.000000000000000,4,430,1,25.0000000,430,1,25.0000000,448,5305
3364,4.000000000000000,0.000277777777778,153,862,709,409.000000000000000,284.927183680322059,1636.000000000000000,4,153,1,25.0000000,153,1,25.0000000,179,862
3365,4.000000000000000,0.000277777777778,658,1022,364,805.500000000000000,153.221245263181430,3222.000000000000000,4,658,1,25.0000000,658,1,25.0000000,664,1022
3366,4.000000000000000,0.000277777777778,849,977,128,912.250000000000000,46.922142960440347,3649.000000000000000,4,849,1,25.0000000,849,1,25.0000000,894,977
3367,4.000000000000000,0.000277777777778,143,1447,1304,807.750000000000000,620.719491799637353,3231.000000000000000,4,143,1,25.0000000,143,1,25.0000000,233,1447
3368,4.000000000000000,0.000277777777778,64,833,769,328.750000000000000,302.034248885784507,1315.000000000000000,4,64,1,25.0000000,64,1,25.0000000,132,833
3369,4.000000000000000,0.000277777777778,949,3653,2704,1906.750000000000000,1034.280516832836838,7627.000000000000000,4,949,1,25.0000000,949,1,25.0000000,1486,3653
3370,4.000000000000000,0.000277777777778,1076,2520,1444,1809.500000000000000,670.277740940276317,7238.000000000000000,4,1076,1,25.0000000,1076,1,25.0000000,1207,2520
3371,4.000000000000000,0.000277777777778,1076,2520,1444,1809.500000000000000,670.277740940276317,7238.000000000000000,4,1076,1,25.0000000,1076,1,25.0000000,1207,2520
3372,4.000000000000000,0.000277777777778,127,7698,7571,2137.750000000000000,3212.467071815678537,8551.000000000000000,4,127,1,25.0000000,127,1,25.0000000,261,7698
3373,5.000000000000000,0.000347222222222,623,4803,4180,1625.799999999999955,1598.492089439293977,8129.000000000000000,5,623,1,20.0000000,623,1,20.0000000,951,4803
3374,4.000000000000000,0.000277777777778,769,1384,615,980.250000000000000,242.459661593428763,3921.000000000000000,4,769,1,25.0000000,769,1,25.0000000,817,1384
3375,4.000000000000000,0.000277777777778,908,3038,2130,1830.250000000000000,802.982681942767613,7321.000000000000000,4,908,1,25.0000000,908,1,25.0000000,1349,3038
3376,4.000000000000000,0.000277777777778,975,1266,291,1187.750000000000000,123.159195758985035,4751.000000000000000,3,1266,2,50.0000000,975,1,25.0000000,1244,1266
3377,4.000000000000000,0.000277777777778,285,1529,1244,1018.500000000000000,490.634538123846312,4074.000000000000000,4,285,1,25.0000000,285,1,25.0000000,866,1529
3378,4.000000000000000,0.000277777777778,906,1529,623,1308.250000000000000,238.252360953674469,5233.000000000000000,4,906,1,25.0000000,906,1,25.0000000,1394,1529
3379,4.000000000000000,0.000277777777778,140,822,682,480.000000000000000,241.358654288591850,1920.000000000000000,4,140,1,25.0000000,140,1,25.0000000,464,822
3380,4.000000000000000,0.000277777777778,1204,1741,537,1495.000000000000000,191.330865257020150,5980.000000000000000,4,1204,1,25.0000000,1204,1,25.0000000,1507,1741
3381,6.000000000000000,0.000416666666667,209,894,685,484.166666666666686,224.080652642946603,2905.000000000000000,6,209,1,16.6667004,209,1,16.6667004,348,610
3382,4.000000000000000,0.000277777777778,209,894,685,486.750000000000000,258.297672269805787,1947.000000000000000,4,209,1,25.0000000,209,1,25.0000000,334,894
3383,4.000000000000000,0.000277777777778,209,894,685,511.750000000000000,264.112073749005276,2047.000000000000000,4,209,1,25.0000000,209,1,25.0000000,334,894
3384,5.000000000000000,0.000347222222222,59,3199,3140,832.399999999999977,1193.605562989717328,4162.000000000000000,4,187,2,40.0000000,59,1,20.0000000,187,3199
3385,4.000000000000000,0.000277777777778,179,1620,1441,796.500000000000000,566.191001341420133,3186.000000000000000,4,179,1,25.0000000,179,1,25.0000000,376,1620
3386,4.000000000000000,0.000277777777778,0,1856,1856,746.000000000000000,780.369463779817579,2984.000000000000000,4,0,1,25.0000000,0,1,25.0000000,25,1856
3387,4.000000000000000,0.000277777777778,589,914,325,755.500000000000000,121.261081967793785,3022.000000000000000,4,589,1,25.0000000,589,1,25.0000000,705,914
3388,3.000000000000000,0.000208333333333,312,876,564,564.666666666666629,233.959160728723987,1694.000000000000000,3,312,1,33.3333015,312,1,33.3333015,506,876
3389,4.000000000000000,0.000277777777778,28,750,722,345.750000000000000,279.387164164712487,1383.000000000000000,4,28,1,25.0000000,28,1,25.0000000,154,750
3390,4.000000000000000,0.000277777777778,126,929,803,556.750000000000000,334.975652100268348,2227.000000000000000,4,126,1,25.0000000,126,1,25.0000000,338,929
3391,3.000000000000000,0.000208333333333,179,1072,893,632.666666666666629,364.706579168636495,1898.000000000000000,3,179,1,33.3333015,179,1,33.3333015,647,1072
3392,4.000000000000000,0.000277777777778,1,94,93,35.750000000000000,38.518664307060284,143.000000000000000,3,1,2,50.0000000,47,1,25.0000000,1,94
3393,4.000000000000000,0.000277777777778,0,125,125,46.250000000000000,49.816538418481066,185.000000000000000,4,0,1,25.0000000,0,1,25.0000000,7,125
3394,5.000000000000000,0.000347222222222,339,2101,1762,1058.599999999999909,601.315424714849655,5293.000000000000000,5,339,1,20.0000000,339,1,20.0000000,1059,2101
3395,4.000000000000000,0.000277777777778,620,3060,2440,1267.000000000000000,1035.925431679326948,5068.000000000000000,4,620,1,25.0000000,620,1,25.0000000,659,3060
3396,4.000000000000000,0.000277777777778,1,233,232,71.500000000000000,95.198476878571967,286.000000000000000,4,1,1,25.0000000,1,1,25.0000000,3,233
3397,4.000000000000000,0.000277777777778,221,1161,940,610.000000000000000,405.515721026941208,2440.000000000000000,3,221,2,50.0000000,837,1,25.0000000,221,1161
3398,5.000000000000000,0.000347222222222,213,1171,958,597.399999999999977,464.279915568183924,2987.000000000000000,4,221,2,40.0000000,213,1,20.0000000,221,1171
3399,4.000000000000000,0.000277777777778,497,2466,1969,1108.500000000000000,796.451034276433120,4434.000000000000000,4,497,1,25.0000000,497,1,25.0000000,590,2466
3400,4.000000000000000,0.000277777777778,386,2429,2043,1142.250000000000000,814.110979842429060,4569.000000000000000,4,386,1,25.0000000,386,1,25.0000000,501,2429
3401,4.000000000000000,0.000277777777778,240,1829,1589,1124.750000000000000,569.141623411958903,4499.000000000000000,4,240,1,25.0000000,240,1,25.0000000,1197,1829
3402,3.000000000000000,0.000208333333333,332,864,532,569.000000000000000,221.026393597386146,1707.000000000000000,3,332,1,33.3333015,332,1,33.3333015,511,864
3403,4.000000000000000,0.000277777777778,242,557,315,354.250000000000000,120.882949583471031,1417.000000000000000,4,242,1,25.0000000,242,1,25.0000000,291,557
3404,4.000000000000000,0.000277777777778,378,1816,1438,1043.750000000000000,514.119818233065189,4175.000000000000000,4,378,1,25.0000000,378,1,25.0000000,913,1816
3405,4.000000000000000,0.000277777777778,32,814,782,296.500000000000000,307.822595012127067,1186.000000000000000,4,32,1,25.0000000,32,1,25.0000000,102,814
3406,5.000000000000000,0.000347222222222,311,915,604,766.000000000000000,228.227079900698897,3830.000000000000000,3,868,3,60.0000000,311,1,20.0000000,868,915
3407,4.000000000000000,0.000277777777778,894,2211,1317,1625.500000000000000,475.547316257804141,6502.000000000000000,4,894,1,25.0000000,894,1,25.0000000,1609,2211
3408,4.000000000000000,0.000277777777778,647,962,315,740.250000000000000,128.643645393000270,2961.000000000000000,4,647,1,25.0000000,647,1,25.0000000,670,962
3409,5.000000000000000,0.000347222222222,630,4369,3739,1618.800000000000182,1389.744062768393405,8094.000000000000000,5,630,1,20.0000000,630,1,20.0000000,947,4369
3410,4.000000000000000,0.000277777777778,228,894,666,628.750000000000000,272.453092292967028,2515.000000000000000,4,228,1,25.0000000,228,1,25.0000000,528,894
3411,3.000000000000000,0.000208333333333,654,748,94,705.666666666666629,38.938698260499443,2117.000000000000000,3,654,1,33.3333015,654,1,33.3333015,715,748
3412,4.000000000000000,0.000277777777778,353,1287,934,873.250000000000000,334.516348628882440,3493.000000000000000,4,353,1,25.0000000,353,1,25.0000000,920,1287
3413,3.000000000000000,0.000208333333333,830,1810,980,1226.000000000000000,421.590638732250170,3678.000000000000000,3,830,1,33.3333015,830,1,33.3333015,1038,1810
3414,4.000000000000000,0.000277777777778,636,1064,428,868.000000000000000,192.353840616713455,3472.000000000000000,4,636,1,25.0000000,636,1,25.0000000,720,1064
3415,3.000000000000000,0.000208333333333,547,1176,629,878.666666666666742,257.933238562918746,2636.000000000000000,3,547,1,33.3333015,547,1,33.3333015,913,1176
3416,4.000000000000000,0.000277777777778,75,1381,1306,664.000000000000000,514.521622480532869,2656.000000000000000,4,75,1,25.0000000,75,1,25.0000000,292,1381
3417,3.000000000000000,0.000208333333333,75,908,833,425.000000000000000,352.835183430828920,1275.000000000000000,3,75,1,33.3333015,75,1,33.3333015,292,908
3418,4.000000000000000,0.000277777777778,75,1344,1269,654.750000000000000,501.721723169328186,2619.000000000000000,4,75,1,25.0000000,75,1,25.0000000,292,1344
3419,4.000000000000000,0.000277777777778,25,292,267,146.000000000000000,95.333624708179428,584.000000000000000,4,25,1,25.0000000,25,1,25.0000000,127,292
3420,4.000000000000000,0.000277777777778,580,8038,7458,2556.750000000000000,3167.886312275110868,10227.000000000000000,4,580,1,25.0000000,580,1,25.0000000,647,8038
3421,4.000000000000000,0.000277777777778,36,3368,3332,1255.750000000000000,1260.528931639413031,5023.000000000000000,4,36,1,25.0000000,36,1,25.0000000,746,3368
3422,4.000000000000000,0.000277777777778,36,3368,3332,1255.750000000000000,1260.528931639413031,5023.000000000000000,4,36,1,25.0000000,36,1,25.0000000,746,3368
3423,4.000000000000000,0.000277777777778,36,3368,3332,1255.750000000000000,1260.528931639413031,5023.000000000000000,4,36,1,25.0000000,36,1,25.0000000,746,3368
3424,3.000000000000000,0.000208333333333,746,931,185,850.000000000000000,77.257146379261684,2550.000000000000000,3,746,1,33.3333015,746,1,33.3333015,873,931
3425,4.000000000000000,0.000277777777778,890,3964,3074,2833.500000000000000,1161.839597362734139,11334.000000000000000,4,890,1,25.0000000,890,1,25.0000000,3157,3964
3426,4.000000000000000,0.000277777777778,804,1451,647,1116.000000000000000,235.668198957771978,4464.000000000000000,4,804,1,25.0000000,804,1,25.0000000,1026,1451
3427,4.000000000000000,0.000277777777778,367,1615,1248,1070.250000000000000,458.419772152118242,4281.000000000000000,4,367,1,25.0000000,367,1,25.0000000,1014,1615
3428,3.000000000000000,0.000208333333333,231,873,642,657.333333333333371,301.470101705330364,1972.000000000000000,3,231,1,33.3333015,231,1,33.3333015,868,873
3429,5.000000000000000,0.000347222222222,231,873,642,688.600000000000023,240.345251669343384,3443.000000000000000,5,231,1,20.0000000,231,1,20.0000000,802,873
3430,4.000000000000000,0.000277777777778,570,993,423,789.000000000000000,196.754923699509988,3156.000000000000000,4,570,1,25.0000000,570,1,25.0000000,616,993
3431,4.000000000000000,0.000277777777778,879,1451,572,1128.750000000000000,239.660567261283092,4515.000000000000000,4,879,1,25.0000000,879,1,25.0000000,918,1451
3432,4.000000000000000,0.000277777777778,2259,6585,4326,4567.000000000000000,1541.419475678181470,18268.000000000000000,4,2259,1,25.0000000,2259,1,25.0000000,4535,6585
3433,4.000000000000000,0.000277777777778,0,1410,1410,430.000000000000000,573.705063599755931,1720.000000000000000,4,0,1,25.0000000,0,1,25.0000000,55,1410
3434,3.000000000000000,0.000208333333333,720,3430,2710,2417.333333333333485,1207.642699182539218,7252.000000000000000,3,720,1,33.3333015,720,1,33.3333015,3102,3430
3435,5.000000000000000,0.000347222222222,39,1162,1123,596.199999999999932,396.503417387542868,2981.000000000000000,5,39,1,20.0000000,39,1,20.0000000,711,1162
3436,4.000000000000000,0.000277777777778,39,1162,1123,676.500000000000000,405.312533731687154,2706.000000000000000,4,39,1,25.0000000,39,1,25.0000000,711,1162
3437,4.000000000000000,0.000277777777778,325,1026,701,726.000000000000000,257.139067432391528,2904.000000000000000,4,325,1,25.0000000,325,1,25.0000000,711,1026
3438,4.000000000000000,0.000277777777778,193,4380,4187,1572.000000000000000,1649.661935064272484,6288.000000000000000,4,193,1,25.0000000,193,1,25.0000000,660,4380
3439,4.000000000000000,0.000277777777778,1065,2106,1041,1489.500000000000000,440.960599146907896,5958.000000000000000,4,1065,1,25.0000000,1065,1,25.0000000,1078,2106
3440,4.000000000000000,0.000277777777778,58,946,888,434.000000000000000,321.247568084180216,1736.000000000000000,4,58,1,25.0000000,58,1,25.0000000,362,946
3441,4.000000000000000,0.000277777777778,218,3843,3625,1526.000000000000000,1382.314544523061841,6104.000000000000000,4,218,1,25.0000000,218,1,25.0000000,856,3843
3442,4.000000000000000,0.000277777777778,218,3843,3625,1526.000000000000000,1382.314544523061841,6104.000000000000000,4,218,1,25.0000000,218,1,25.0000000,856,3843
3443,4.000000000000000,0.000277777777778,218,3843,3625,1307.250000000000000,1484.136343972480290,5229.000000000000000,4,218,1,25.0000000,218,1,25.0000000,312,3843
3444,4.000000000000000,0.000277777777778,231,967,736,532.000000000000000,270.338676478227910,2128.000000000000000,4,231,1,25.0000000,231,1,25.0000000,423,967
3445,4.000000000000000,0.000277777777778,304,1086,782,810.750000000000000,300.360928717434888,3243.000000000000000,4,304,1,25.0000000,304,1,25.0000000,899,1086
3446,3.000000000000000,0.000208333333333,304,1086,782,758.000000000000000,331.449342534672496,2274.000000000000000,3,304,1,33.3333015,304,1,33.3333015,884,1086
3447,5.000000000000000,0.000347222222222,292,2735,2443,1102.000000000000000,842.682383819668985,5510.000000000000000,5,292,1,20.0000000,292,1,20.0000000,835,2735
3448,3.000000000000000,0.000208333333333,143,754,611,440.666666666666686,249.685580057977916,1322.000000000000000,3,143,1,33.3333015,143,1,33.3333015,425,754
3449,4.000000000000000,0.000277777777778,607,1290,683,1025.500000000000000,256.369362444111118,4102.000000000000000,4,607,1,25.0000000,607,1,25.0000000,1048,1290
3450,4.000000000000000,0.000277777777778,797,1176,379,998.500000000000000,135.931048697492201,3994.000000000000000,4,797,1,25.0000000,797,1,25.0000000,983,1176
3451,4.000000000000000,0.000277777777778,818,7581,6763,2769.000000000000000,2794.360660330015435,11076.000000000000000,4,818,1,25.0000000,818,1,25.0000000,1039,7581
3452,4.000000000000000,0.000277777777778,179,1620,1441,796.500000000000000,566.191001341420133,3186.000000000000000,4,179,1,25.0000000,179,1,25.0000000,376,1620
3453,5.000000000000000,0.000347222222222,388,1200,812,794.200000000000045,286.656868049589889,3971.000000000000000,5,388,1,20.0000000,388,1,20.0000000,900,1200
3454,4.000000000000000,0.000277777777778,388,1200,812,762.500000000000000,312.555195125596981,3050.000000000000000,4,388,1,25.0000000,388,1,25.0000000,562,1200
3455,4.000000000000000,0.000277777777778,664,1273,609,879.000000000000000,235.103168842957103,3516.000000000000000,4,664,1,25.0000000,664,1,25.0000000,747,1273
3456,5.000000000000000,0.000347222222222,693,1623,930,1199.799999999999955,303.925912024624836,5999.000000000000000,5,693,1,20.0000000,693,1,20.0000000,1198,1623
3457,4.000000000000000,0.000277777777778,899,1623,724,1267.000000000000000,261.477532495623791,5068.000000000000000,4,899,1,25.0000000,899,1,25.0000000,1198,1623
3458,4.000000000000000,0.000277777777778,3,102,99,50.750000000000000,37.049797570297201,203.000000000000000,4,3,1,25.0000000,3,1,25.0000000,32,102
3459,4.000000000000000,0.000277777777778,391,1394,1003,879.500000000000000,354.852434118747453,3518.000000000000000,4,391,1,25.0000000,391,1,25.0000000,866,1394
3460,4.000000000000000,0.000277777777778,821,2606,1785,1393.500000000000000,727.900577002106843,5574.000000000000000,4,821,1,25.0000000,821,1,25.0000000,832,2606
3461,4.000000000000000,0.000277777777778,241,1200,959,657.000000000000000,354.983802447379276,2628.000000000000000,4,241,1,25.0000000,241,1,25.0000000,475,1200
3462,4.000000000000000,0.000277777777778,85,820,735,307.000000000000000,297.953855487724809,1228.000000000000000,4,85,1,25.0000000,85,1,25.0000000,149,820
3463,5.000000000000000,0.000347222222222,94,1868,1774,807.200000000000045,613.030309201755585,4036.000000000000000,5,94,1,20.0000000,94,1,20.0000000,850,1868
3464,4.000000000000000,0.000277777777778,507,1728,1221,1093.750000000000000,556.711044887740627,4375.000000000000000,4,507,1,25.0000000,507,1,25.0000000,574,1728
3465,4.000000000000000,0.000277777777778,75,647,572,253.000000000000000,229.281486387366215,1012.000000000000000,4,75,1,25.0000000,75,1,25.0000000,141,647
3466,4.000000000000000,0.000277777777778,271,1207,936,849.000000000000000,351.215745660697849,3396.000000000000000,4,271,1,25.0000000,271,1,25.0000000,900,1207
3467,5.000000000000000,0.000347222222222,630,2572,1942,1255.200000000000045,679.952468927056771,6276.000000000000000,5,630,1,20.0000000,630,1,20.0000000,1082,2572
3468,4.000000000000000,0.000277777777778,989,1544,555,1153.000000000000000,227.291662847540437,4612.000000000000000,4,989,1,25.0000000,989,1,25.0000000,1016,1544
3469,4.000000000000000,0.000277777777778,500,2056,1556,1098.500000000000000,645.972329128732895,4394.000000000000000,4,500,1,25.0000000,500,1,25.0000000,513,2056
3470,4.000000000000000,0.000277777777778,500,2056,1556,1098.500000000000000,645.972329128732895,4394.000000000000000,4,500,1,25.0000000,500,1,25.0000000,513,2056
3471,5.000000000000000,0.000347222222222,500,2056,1556,1119.000000000000000,721.500658350357980,5595.000000000000000,5,500,1,20.0000000,500,1,20.0000000,580,2056
3472,4.000000000000000,0.000277777777778,500,2056,1556,912.250000000000000,661.041744143287815,3649.000000000000000,4,500,1,25.0000000,500,1,25.0000000,513,2056
3473,4.000000000000000,0.000277777777778,500,2056,1556,1098.500000000000000,645.972329128732895,4394.000000000000000,4,500,1,25.0000000,500,1,25.0000000,513,2056
3474,4.000000000000000,0.000277777777778,266,2056,1790,853.749999999999886,703.900694345445345,3415.000000000000000,4,266,1,25.0000000,266,1,25.0000000,513,2056
3475,3.000000000000000,0.000208333333333,500,1088,588,700.333333333333371,274.173100228466808,2101.000000000000000,3,500,1,33.3333015,500,1,33.3333015,513,1088
3476,5.000000000000000,0.000347222222222,685,1617,932,1285.799999999999955,338.030412832928391,6429.000000000000000,5,685,1,20.0000000,685,1,20.0000000,1376,1617
3477,4.000000000000000,0.000277777777778,521,1722,1201,1188.250000000000000,512.609195684197630,4753.000000000000000,4,521,1,25.0000000,521,1,25.0000000,860,1722
3478,4.000000000000000,0.000277777777778,369,1905,1536,941.750000000000000,584.091334895493901,3767.000000000000000,4,369,1,25.0000000,369,1,25.0000000,619,1905
3479,5.000000000000000,0.000347222222222,369,1905,1536,912.200000000000045,525.759412659440727,4561.000000000000000,5,369,1,20.0000000,369,1,20.0000000,794,1905
3480,5.000000000000000,0.000347222222222,231,1114,883,706.200000000000045,283.815010173880694,3531.000000000000000,5,231,1,20.0000000,231,1,20.0000000,715,1114
3481,4.000000000000000,0.000277777777778,304,1212,908,882.500000000000000,359.264178565022007,3530.000000000000000,4,304,1,25.0000000,304,1,25.0000000,862,1212
3482,5.000000000000000,0.000347222222222,304,1152,848,779.399999999999977,272.827857815143204,3897.000000000000000,5,304,1,20.0000000,304,1,20.0000000,802,1152
3483,4.000000000000000,0.000277777777778,304,1212,908,882.500000000000000,359.264178565022007,3530.000000000000000,4,304,1,25.0000000,304,1,25.0000000,862,1212
3484,4.000000000000000,0.000277777777778,875,1251,376,1069.750000000000000,141.406108425343518,4279.000000000000000,4,875,1,25.0000000,875,1,25.0000000,1009,1251
3485,5.000000000000000,0.000347222222222,64,932,868,473.600000000000023,289.190317956877664,2368.000000000000000,5,64,1,20.0000000,64,1,20.0000000,434,932
3486,4.000000000000000,0.000277777777778,683,4578,3895,1691.750000000000000,1666.660639572435684,6767.000000000000000,4,683,1,25.0000000,683,1,25.0000000,737,4578
3487,4.000000000000000,0.000277777777778,845,3533,2688,1784.250000000000000,1033.086001986281872,7137.000000000000000,4,845,1,25.0000000,845,1,25.0000000,1356,3533
3488,4.000000000000000,0.000277777777778,623,1767,1144,1107.000000000000000,427.476899960687945,4428.000000000000000,4,623,1,25.0000000,623,1,25.0000000,868,1767
3489,4.000000000000000,0.000277777777778,257,1233,976,768.000000000000000,362.361007836108115,3072.000000000000000,4,257,1,25.0000000,257,1,25.0000000,638,1233
3490,4.000000000000000,0.000277777777778,779,1589,810,1136.000000000000000,291.486706386414824,4544.000000000000000,4,779,1,25.0000000,779,1,25.0000000,1052,1589
3491,4.000000000000000,0.000277777777778,728,2533,1805,1280.250000000000000,731.387850254569230,5121.000000000000000,4,728,1,25.0000000,728,1,25.0000000,830,2533
3492,5.000000000000000,0.000347222222222,1676,4206,2530,2791.800000000000182,1011.946125048166778,13959.000000000000000,5,1676,1,20.0000000,1676,1,20.0000000,2261,4206
3493,4.000000000000000,0.000277777777778,1013,3722,2709,1846.750000000000227,1093.654510117340578,7387.000000000000000,4,1013,1,25.0000000,1013,1,25.0000000,1203,3722
3494,4.000000000000000,0.000277777777778,1013,1449,436,1219.000000000000000,154.641520944408683,4876.000000000000000,4,1013,1,25.0000000,1013,1,25.0000000,1203,1449
3495,4.000000000000000,0.000277777777778,0,2009,2009,901.250000000000000,913.002019439168635,3605.000000000000000,3,0,2,50.0000000,1596,1,25.0000000,0,2009
3496,3.000000000000000,0.000208333333333,1105,2095,990,1765.000000000000000,466.690475583121383,5295.000000000000000,2,2095,2,66.6667023,1105,1,33.3333015,2095,2095
3497,4.000000000000000,0.000277777777778,657,2340,1683,1336.750000000000000,616.633349325188533,5347.000000000000000,4,657,1,25.0000000,657,1,25.0000000,1170,2340
3498,4.000000000000000,0.000277777777778,494,1043,549,820.250000000000000,223.637401836097183,3281.000000000000000,4,494,1,25.0000000,494,1,25.0000000,733,1043
3499,4.000000000000000,0.000277777777778,653,818,165,744.000000000000000,62.533990757027503,2976.000000000000000,4,653,1,25.0000000,653,1,25.0000000,723,818
3500,4.000000000000000,0.000277777777778,425,1112,687,766.500000000000000,242.905845956823356,3066.000000000000000,4,425,1,25.0000000,425,1,25.0000000,762,1112
3501,4.000000000000000,0.000277777777778,425,1112,687,795.500000000000000,248.103305096889017,3182.000000000000000,4,425,1,25.0000000,425,1,25.0000000,762,1112
3502,4.000000000000000,0.000277777777778,681,1149,468,908.000000000000000,173.259920350899392,3632.000000000000000,4,681,1,25.0000000,681,1,25.0000000,829,1149
3503,4.000000000000000,0.000277777777778,986,3352,2366,1601.250000000000000,1010.982535704746965,6405.000000000000000,4,986,1,25.0000000,986,1,25.0000000,1032,3352
3504,5.000000000000000,0.000347222222222,274,1477,1203,1068.799999999999955,440.544390498846326,5344.000000000000000,4,1477,2,40.0000000,274,1,20.0000000,1109,1477
3505,5.000000000000000,0.000347222222222,193,2053,1860,880.200000000000045,667.396553781932539,4401.000000000000000,5,193,1,20.0000000,193,1,20.0000000,660,2053
3506,4.000000000000000,0.000277777777778,1120,1596,476,1308.250000000000000,189.069266407843287,5233.000000000000000,4,1120,1,25.0000000,1120,1,25.0000000,1159,1596
3507,4.000000000000000,0.000277777777778,1120,1596,476,1308.250000000000000,189.069266407843287,5233.000000000000000,4,1120,1,25.0000000,1120,1,25.0000000,1159,1596
3508,3.000000000000000,0.000208333333333,137,300,163,243.666666666666686,75.464487601049058,731.000000000000000,3,137,1,33.3333015,137,1,33.3333015,294,300
3509,4.000000000000000,0.000277777777778,566,4221,3655,2486.000000000000000,1573.336423019565245,9944.000000000000000,4,566,1,25.0000000,566,1,25.0000000,1316,4221
3510,4.000000000000000,0.000277777777778,827,1696,869,1145.750000000000000,329.857071320291709,4583.000000000000000,4,827,1,25.0000000,827,1,25.0000000,985,1696
3511,4.000000000000000,0.000277777777778,636,2372,1736,1198.000000000000000,696.519920748861296,4792.000000000000000,4,636,1,25.0000000,636,1,25.0000000,720,2372
3512,4.000000000000000,0.000277777777778,636,2459,1823,1825.000000000000000,727.143383384597655,7300.000000000000000,4,636,1,25.0000000,636,1,25.0000000,1833,2459
3513,4.000000000000000,0.000277777777778,992,2056,1064,1569.750000000000000,427.720922448271153,6279.000000000000000,4,992,1,25.0000000,992,1,25.0000000,1335,2056
3514,4.000000000000000,0.000277777777778,496,1092,596,671.500000000000000,244.000512294544166,2686.000000000000000,4,496,1,25.0000000,496,1,25.0000000,533,1092
3515,4.000000000000000,0.000277777777778,444,715,271,629.250000000000000,108.042526349581436,2517.000000000000000,4,444,1,25.0000000,444,1,25.0000000,673,715
3516,3.000000000000000,0.000208333333333,452,2479,2027,1247.000000000000000,883.330440246834542,3741.000000000000000,3,452,1,33.3333015,452,1,33.3333015,810,2479
3517,4.000000000000000,0.000277777777778,1036,2076,1040,1372.500000000000000,411.643352916089270,5490.000000000000000,4,1036,1,25.0000000,1036,1,25.0000000,1155,2076
3518,4.000000000000000,0.000277777777778,195,928,733,529.750000000000000,330.253217243980828,2119.000000000000000,4,195,1,25.0000000,195,1,25.0000000,212,928
3519,4.000000000000000,0.000277777777778,1289,2103,814,1566.500000000000000,327.164713867495209,6266.000000000000000,4,1289,1,25.0000000,1289,1,25.0000000,1315,2103
3520,4.000000000000000,0.000277777777778,311,675,364,520.250000000000000,137.686918405489791,2081.000000000000000,4,311,1,25.0000000,311,1,25.0000000,490,675
3521,4.000000000000000,0.000277777777778,230,629,399,397.250000000000000,147.723347849959055,1589.000000000000000,4,230,1,25.0000000,230,1,25.0000000,323,629
3522,4.000000000000000,0.000277777777778,231,967,736,553.750000000000000,264.122485790210590,2215.000000000000000,4,231,1,25.0000000,231,1,25.0000000,507,967
3523,4.000000000000000,0.000277777777778,231,967,736,553.750000000000000,264.122485790210590,2215.000000000000000,4,231,1,25.0000000,231,1,25.0000000,507,967
3524,4.000000000000000,0.000277777777778,574,931,357,756.750000000000000,126.416721599636503,3027.000000000000000,4,574,1,25.0000000,574,1,25.0000000,753,931
3525,5.000000000000000,0.000347222222222,596,1349,753,918.799999999999955,291.654178780280802,4594.000000000000000,5,596,1,20.0000000,596,1,20.0000000,875,1349
3526,5.000000000000000,0.000347222222222,352,5615,5263,1744.599999999999909,1952.883877756176162,8723.000000000000000,5,352,1,20.0000000,352,1,20.0000000,997,5615
3527,4.000000000000000,0.000277777777778,660,2890,2230,1561.000000000000000,886.014108239818029,6244.000000000000000,4,660,1,25.0000000,660,1,25.0000000,862,2890
3528,4.000000000000000,0.000277777777778,660,2890,2230,1561.000000000000000,886.014108239818029,6244.000000000000000,4,660,1,25.0000000,660,1,25.0000000,862,2890
3529,4.000000000000000,0.000277777777778,511,2564,2053,1449.000000000000000,919.966575479783387,5796.000000000000000,4,511,1,25.0000000,511,1,25.0000000,571,2564
3530,3.000000000000000,0.000208333333333,362,2916,2554,1226.333333333333258,1194.880840177053869,3679.000000000000000,3,362,1,33.3333015,362,1,33.3333015,401,2916
3531,4.000000000000000,0.000277777777778,636,2459,1823,1747.500000000000000,679.684669534336308,6990.000000000000000,4,636,1,25.0000000,636,1,25.0000000,1833,2459
3532,4.000000000000000,0.000277777777778,636,2459,1823,1498.000000000000000,701.274910430994964,5992.000000000000000,4,636,1,25.0000000,636,1,25.0000000,1064,2459
3533,4.000000000000000,0.000277777777778,636,2459,1823,1302.750000000000000,689.446653121182408,5211.000000000000000,4,636,1,25.0000000,636,1,25.0000000,1052,2459
3534,4.000000000000000,0.000277777777778,311,1773,1462,782.000000000000000,583.901532794699847,3128.000000000000000,4,311,1,25.0000000,311,1,25.0000000,411,1773
3535,4.000000000000000,0.000277777777778,325,2288,1963,980.750000000000000,784.773016546822873,3923.000000000000000,4,325,1,25.0000000,325,1,25.0000000,418,2288
3536,4.000000000000000,0.000277777777778,376,2240,1864,1027.250000000000000,734.018860452509102,4109.000000000000000,4,376,1,25.0000000,376,1,25.0000000,520,2240
3537,3.000000000000000,0.000208333333333,272,3810,3538,1550.000000000000000,1602.623682174535588,4650.000000000000000,3,272,1,33.3333015,272,1,33.3333015,568,3810
3538,4.000000000000000,0.000277777777778,547,912,365,743.250000000000000,130.269672218824581,2973.000000000000000,4,547,1,25.0000000,547,1,25.0000000,741,912
3539,4.000000000000000,0.000277777777778,597,1466,869,1065.000000000000000,345.210805161136307,4260.000000000000000,4,597,1,25.0000000,597,1,25.0000000,881,1466
3540,5.000000000000000,0.000347222222222,574,1466,892,955.799999999999955,355.964829723387140,4779.000000000000000,5,574,1,20.0000000,574,1,20.0000000,881,1466
3541,4.000000000000000,0.000277777777778,597,1466,869,1051.250000000000000,335.909493018580804,4205.000000000000000,4,597,1,25.0000000,597,1,25.0000000,881,1466
3542,4.000000000000000,0.000277777777778,391,1029,638,651.500000000000000,256.621803438445170,2606.000000000000000,4,391,1,25.0000000,391,1,25.0000000,441,1029
3543,5.000000000000000,0.000347222222222,560,1475,915,922.799999999999955,348.625529759368021,4614.000000000000000,5,560,1,20.0000000,560,1,20.0000000,724,1475
3544,4.000000000000000,0.000277777777778,662,1370,708,1089.250000000000000,278.843482082690969,4357.000000000000000,4,662,1,25.0000000,662,1,25.0000000,1023,1370
3545,4.000000000000000,0.000277777777778,221,1171,950,679.750000000000000,459.325252408356107,2719.000000000000000,3,221,2,50.0000000,1106,1,25.0000000,221,1171
3546,4.000000000000000,0.000277777777778,221,1161,940,610.000000000000000,405.515721026941208,2440.000000000000000,3,221,2,50.0000000,837,1,25.0000000,221,1161
3547,4.000000000000000,0.000277777777778,221,1161,940,610.000000000000000,405.515721026941208,2440.000000000000000,3,221,2,50.0000000,837,1,25.0000000,221,1161
3548,4.000000000000000,0.000277777777778,221,1171,950,679.750000000000000,459.325252408356107,2719.000000000000000,3,221,2,50.0000000,1106,1,25.0000000,221,1171
3549,4.000000000000000,0.000277777777778,893,977,84,935.750000000000000,29.760502347910730,3743.000000000000000,4,893,1,25.0000000,893,1,25.0000000,934,977
3550,4.000000000000000,0.000277777777778,726,1126,400,914.250000000000000,146.683971516999776,3657.000000000000000,4,726,1,25.0000000,726,1,25.0000000,850,1126
3551,4.000000000000000,0.000277777777778,253,724,471,548.500000000000000,177.003531038225333,2194.000000000000000,4,253,1,25.0000000,253,1,25.0000000,608,724
3552,4.000000000000000,0.000277777777778,615,1614,999,1079.250000000000000,374.081792526714651,4317.000000000000000,4,615,1,25.0000000,615,1,25.0000000,877,1614
3553,4.000000000000000,0.000277777777778,824,1802,978,1483.250000000000000,385.592644509720913,5933.000000000000000,4,824,1,25.0000000,824,1,25.0000000,1637,1802
3554,4.000000000000000,0.000277777777778,222,749,527,562.750000000000000,201.825884117969366,2251.000000000000000,4,222,1,25.0000000,222,1,25.0000000,630,749
3555,4.000000000000000,0.000277777777778,972,2162,1190,1356.500000000000000,482.102945438004951,5426.000000000000000,4,972,1,25.0000000,972,1,25.0000000,997,2162
3556,4.000000000000000,0.000277777777778,972,2181,1209,1361.250000000000000,490.044066896029278,5445.000000000000000,4,972,1,25.0000000,972,1,25.0000000,997,2181
3557,4.000000000000000,0.000277777777778,660,2890,2230,1544.500000000000000,899.391321950573456,6178.000000000000000,4,660,1,25.0000000,660,1,25.0000000,796,2890
3558,4.000000000000000,0.000277777777778,522,1620,1098,899.500000000000000,427.112104721933633,3598.000000000000000,4,522,1,25.0000000,522,1,25.0000000,660,1620
3559,4.000000000000000,0.000277777777778,216,2055,1839,1057.250000000000000,668.801306443102021,4229.000000000000000,4,216,1,25.0000000,216,1,25.0000000,787,2055
3560,4.000000000000000,0.000277777777778,216,2055,1839,1057.250000000000000,668.801306443102021,4229.000000000000000,4,216,1,25.0000000,216,1,25.0000000,787,2055
3561,3.000000000000000,0.000208333333333,216,1171,955,724.666666666666742,392.360661749988537,2174.000000000000000,3,216,1,33.3333015,216,1,33.3333015,787,1171
3562,4.000000000000000,0.000277777777778,574,1728,1154,956.000000000000000,452.240533344812036,3824.000000000000000,4,574,1,25.0000000,574,1,25.0000000,753,1728
3563,4.000000000000000,0.000277777777778,574,1728,1154,956.000000000000000,452.240533344812036,3824.000000000000000,4,574,1,25.0000000,574,1,25.0000000,753,1728
3564,4.000000000000000,0.000277777777778,376,1620,1244,1141.500000000000000,512.548778166527313,4566.000000000000000,4,376,1,25.0000000,376,1,25.0000000,973,1620
3565,4.000000000000000,0.000277777777778,685,2618,1933,1622.750000000000000,684.216477074324757,6491.000000000000000,4,685,1,25.0000000,685,1,25.0000000,1571,2618
3566,4.000000000000000,0.000277777777778,3,102,99,50.750000000000000,37.049797570297201,203.000000000000000,4,3,1,25.0000000,3,1,25.0000000,32,102
3567,5.000000000000000,0.000347222222222,156,1436,1280,993.600000000000023,472.087110605659348,4968.000000000000000,5,156,1,20.0000000,156,1,20.0000000,1138,1436
3568,4.000000000000000,0.000277777777778,269,3863,3594,1515.250000000000000,1387.917572300314987,6061.000000000000000,4,269,1,25.0000000,269,1,25.0000000,835,3863
3569,4.000000000000000,0.000277777777778,630,1262,632,931.250000000000000,224.968192196141359,3725.000000000000000,4,630,1,25.0000000,630,1,25.0000000,886,1262
3570,4.000000000000000,0.000277777777778,403,1187,784,749.250000000000000,287.668537556681713,2997.000000000000000,4,403,1,25.0000000,403,1,25.0000000,616,1187
3571,4.000000000000000,0.000277777777778,522,1620,1098,899.500000000000000,427.112104721933633,3598.000000000000000,4,522,1,25.0000000,522,1,25.0000000,660,1620
3572,4.000000000000000,0.000277777777778,522,1620,1098,899.500000000000000,427.112104721933633,3598.000000000000000,4,522,1,25.0000000,522,1,25.0000000,660,1620
3573,4.000000000000000,0.000277777777778,522,1620,1098,899.500000000000000,427.112104721933633,3598.000000000000000,4,522,1,25.0000000,522,1,25.0000000,660,1620
3574,3.000000000000000,0.000208333333333,87,633,546,377.000000000000000,224.196342521460423,1131.000000000000000,3,87,1,33.3333015,87,1,33.3333015,411,633
3575,4.000000000000000,0.000277777777778,296,574,278,445.000000000000000,105.415843211540079,1780.000000000000000,4,296,1,25.0000000,296,1,25.0000000,403,574
3576,4.000000000000000,0.000277777777778,296,574,278,445.000000000000000,105.415843211540079,1780.000000000000000,4,296,1,25.0000000,296,1,25.0000000,403,574
3577,4.000000000000000,0.000277777777778,1074,1852,778,1469.500000000000000,353.110818299298160,5878.000000000000000,4,1074,1,25.0000000,1074,1,25.0000000,1163,1852
3578,4.000000000000000,0.000277777777778,379,1598,1219,900.250000000000000,440.108154321184998,3601.000000000000000,4,379,1,25.0000000,379,1,25.0000000,794,1598
3579,4.000000000000000,0.000277777777778,379,963,584,741.500000000000000,218.550337451123625,2966.000000000000000,4,379,1,25.0000000,379,1,25.0000000,794,963
3580,4.000000000000000,0.000277777777778,379,1598,1219,900.250000000000000,440.108154321184998,3601.000000000000000,4,379,1,25.0000000,379,1,25.0000000,794,1598
3581,4.000000000000000,0.000277777777778,561,605,44,581.000000000000000,16.673332000533065,2324.000000000000000,4,561,1,25.0000000,561,1,25.0000000,571,605
3582,4.000000000000000,0.000277777777778,221,1161,940,610.000000000000000,405.515721026941208,2440.000000000000000,3,221,2,50.0000000,837,1,25.0000000,221,1161
3583,4.000000000000000,0.000277777777778,221,1161,940,610.000000000000000,405.515721026941208,2440.000000000000000,3,221,2,50.0000000,837,1,25.0000000,221,1161
3584,4.000000000000000,0.000277777777778,394,794,400,532.750000000000000,159.388479822100066,2131.000000000000000,4,394,1,25.0000000,394,1,25.0000000,414,794
3585,4.000000000000000,0.000277777777778,766,1480,714,964.750000000000000,298.527532231115970,3859.000000000000000,4,766,1,25.0000000,766,1,25.0000000,780,1480
3586,4.000000000000000,0.000277777777778,469,1670,1201,1298.000000000000000,488.484902530262445,5192.000000000000000,4,469,1,25.0000000,469,1,25.0000000,1416,1670
3587,4.000000000000000,0.000277777777778,265,2605,2340,1166.000000000000000,899.971666220664929,4664.000000000000000,4,265,1,25.0000000,265,1,25.0000000,571,2605
3588,4.000000000000000,0.000277777777778,133,627,494,328.500000000000000,186.497319015582633,1314.000000000000000,4,133,1,25.0000000,133,1,25.0000000,220,627
3589,4.000000000000000,0.000277777777778,639,2109,1470,1093.750000000000000,600.489539875591845,4375.000000000000000,4,639,1,25.0000000,639,1,25.0000000,659,2109
3590,4.000000000000000,0.000277777777778,691,3836,3145,1803.000000000000000,1204.542859345403258,7212.000000000000000,4,691,1,25.0000000,691,1,25.0000000,1272,3836
3591,4.000000000000000,0.000277777777778,689,980,291,827.250000000000000,103.139165693736359,3309.000000000000000,3,820,2,50.0000000,689,1,25.0000000,820,980
3592,4.000000000000000,0.000277777777778,513,1946,1433,1331.750000000000000,571.838427792326684,5327.000000000000000,4,513,1,25.0000000,513,1,25.0000000,1088,1946
3593,4.000000000000000,0.000277777777778,513,1946,1433,1204.750000000000000,661.285632310274877,4819.000000000000000,4,513,1,25.0000000,513,1,25.0000000,580,1946
3594,4.000000000000000,0.000277777777778,513,1946,1433,1204.750000000000000,661.285632310274877,4819.000000000000000,4,513,1,25.0000000,513,1,25.0000000,580,1946
3595,5.000000000000000,0.000347222222222,500,1946,1446,925.399999999999977,554.689679009804536,4627.000000000000000,5,500,1,20.0000000,500,1,20.0000000,580,1946
3596,5.000000000000000,0.000347222222222,790,3975,3185,2203.000000000000000,1176.377320420620890,11015.000000000000000,5,790,1,20.0000000,790,1,20.0000000,2327,3975
3597,4.000000000000000,0.000277777777778,1051,2814,1763,1844.000000000000000,680.281926850919717,7376.000000000000000,4,1051,1,25.0000000,1051,1,25.0000000,1391,2814
3598,4.000000000000000,0.000277777777778,1051,2814,1763,1844.000000000000000,680.281926850919717,7376.000000000000000,4,1051,1,25.0000000,1051,1,25.0000000,1391,2814
3599,4.000000000000000,0.000277777777778,1153,1570,417,1258.500000000000000,179.856192553940161,5034.000000000000000,3,1153,2,50.0000000,1158,1,25.0000000,1153,1570
3600,4.000000000000000,0.000277777777778,1356,2464,1108,1815.500000000000000,461.465329141854397,7262.000000000000000,4,1356,1,25.0000000,1356,1,25.0000000,1403,2464
3601,3.000000000000000,0.000208333333333,1356,2464,1108,1953.000000000000000,456.408442808266500,5859.000000000000000,3,1356,1,33.3333015,1356,1,33.3333015,2039,2464
3602,4.000000000000000,0.000277777777778,34,1036,1002,438.500000000000000,402.150158522907930,1754.000000000000000,4,34,1,25.0000000,34,1,25.0000000,110,1036
3603,4.000000000000000,0.000277777777778,96,5035,4939,2360.500000000000000,1917.305726794764496,9442.000000000000000,4,96,1,25.0000000,96,1,25.0000000,1074,5035
3604,4.000000000000000,0.000277777777778,156,1436,1280,869.750000000000000,478.700519636233537,3479.000000000000000,4,156,1,25.0000000,156,1,25.0000000,749,1436
3605,4.000000000000000,0.000277777777778,566,5342,4776,1912.000000000000227,1984.242046727162915,7648.000000000000000,4,566,1,25.0000000,566,1,25.0000000,851,5342
3606,3.000000000000000,0.000208333333333,312,680,368,475.666666666666629,152.962595282492344,1427.000000000000000,3,312,1,33.3333015,312,1,33.3333015,435,680
3607,4.000000000000000,0.000277777777778,788,2520,1732,1537.250000000000000,628.350767883671779,6149.000000000000000,4,788,1,25.0000000,788,1,25.0000000,1309,2520
3608,4.000000000000000,0.000277777777778,380,1070,690,793.500000000000000,257.151220102102570,3174.000000000000000,4,380,1,25.0000000,380,1,25.0000000,800,1070
3609,3.000000000000000,0.000208333333333,304,1800,1496,875.666666666666742,659.688983958013068,2627.000000000000000,3,304,1,33.3333015,304,1,33.3333015,523,1800
3610,4.000000000000000,0.000277777777778,555,2052,1497,1218.750000000000000,547.244632225844725,4875.000000000000000,4,555,1,25.0000000,555,1,25.0000000,978,2052
3611,4.000000000000000,0.000277777777778,1772,3156,1384,2386.750000000000000,579.590103003838408,9547.000000000000000,4,1772,1,25.0000000,1772,1,25.0000000,1884,3156
3612,4.000000000000000,0.000277777777778,1772,3156,1384,2386.750000000000000,579.590103003838408,9547.000000000000000,4,1772,1,25.0000000,1772,1,25.0000000,1884,3156
3613,4.000000000000000,0.000277777777778,279,900,621,512.000000000000000,233.830066501294908,2048.000000000000000,4,279,1,25.0000000,279,1,25.0000000,404,900
3614,3.000000000000000,0.000208333333333,515,4095,3580,1845.666666666666742,1599.387660602922324,5537.000000000000000,3,515,1,33.3333015,515,1,33.3333015,927,4095
3615,4.000000000000000,0.000277777777778,299,878,579,452.250000000000000,245.904834234709568,1809.000000000000000,3,316,2,50.0000000,299,1,25.0000000,316,878
3616,4.000000000000000,0.000277777777778,685,808,123,751.000000000000000,48.440685379131473,3004.000000000000000,4,685,1,25.0000000,685,1,25.0000000,726,808
3617,4.000000000000000,0.000277777777778,751,1467,716,1005.750000000000000,273.533704504581976,4023.000000000000000,4,751,1,25.0000000,751,1,25.0000000,890,1467
3618,3.000000000000000,0.000208333333333,128,911,783,578.333333333333258,330.309282676436851,1735.000000000000000,3,128,1,33.3333015,128,1,33.3333015,696,911
3619,4.000000000000000,0.000277777777778,815,3722,2907,1752.250000000000000,1172.746002977626858,7009.000000000000000,4,815,1,25.0000000,815,1,25.0000000,912,3722
3620,3.000000000000000,0.000208333333333,294,788,494,460.666666666666686,231.472580569612091,1382.000000000000000,3,294,1,33.3333015,294,1,33.3333015,300,788
3621,4.000000000000000,0.000277777777778,1676,4206,2530,2984.000000000000000,1046.584683625744674,11936.000000000000000,4,1676,1,25.0000000,1676,1,25.0000000,2261,4206
3622,5.000000000000000,0.000347222222222,588,6637,6049,2317.800000000000182,2186.994961128168597,11589.000000000000000,5,588,1,20.0000000,588,1,20.0000000,1509,6637
3623,4.000000000000000,0.000277777777778,330,1598,1268,1019.000000000000000,541.726406962038368,4076.000000000000000,4,330,1,25.0000000,330,1,25.0000000,651,1598
3624,3.000000000000000,0.000208333333333,391,785,394,529.333333333333371,180.986801237610194,1588.000000000000000,3,391,1,33.3333015,391,1,33.3333015,412,785
3625,4.000000000000000,0.000277777777778,817,2169,1352,1466.250000000000000,502.203830630551863,5865.000000000000000,4,817,1,25.0000000,817,1,25.0000000,1225,2169
3626,4.000000000000000,0.000277777777778,294,1472,1178,943.250000000000000,472.705709189131767,3773.000000000000000,4,294,1,25.0000000,294,1,25.0000000,699,1472
3627,4.000000000000000,0.000277777777778,403,923,520,650.750000000000000,187.957940773993386,2603.000000000000000,4,403,1,25.0000000,403,1,25.0000000,586,923
3628,3.000000000000000,0.000208333333333,310,731,421,565.000000000000000,183.031873362719722,1695.000000000000000,3,310,1,33.3333015,310,1,33.3333015,654,731
3629,4.000000000000000,0.000277777777778,1007,2039,1032,1527.250000000000000,376.206309755697703,6109.000000000000000,4,1007,1,25.0000000,1007,1,25.0000000,1402,2039
3630,4.000000000000000,0.000277777777778,1249,1712,463,1476.250000000000000,220.578075746434934,5905.000000000000000,4,1249,1,25.0000000,1249,1,25.0000000,1263,1712
3631,4.000000000000000,0.000277777777778,690,1138,448,911.250000000000000,199.074577734074325,3645.000000000000000,4,690,1,25.0000000,690,1,25.0000000,738,1138
3632,3.000000000000000,0.000208333333333,232,1186,954,805.000000000000000,412.453633757783734,2415.000000000000000,3,232,1,33.3333015,232,1,33.3333015,997,1186
3633,4.000000000000000,0.000277777777778,140,2725,2585,904.500000000000000,1066.233206198343851,3618.000000000000000,4,140,1,25.0000000,140,1,25.0000000,163,2725
3634,4.000000000000000,0.000277777777778,747,1638,891,1392.250000000000000,374.188705735488497,5569.000000000000000,4,747,1,25.0000000,747,1,25.0000000,1550,1638
3635,4.000000000000000,0.000277777777778,944,7120,6176,3307.250000000000000,2406.581743365473358,13229.000000000000000,4,944,1,25.0000000,944,1,25.0000000,1584,7120
3636,4.000000000000000,0.000277777777778,680,899,219,747.750000000000000,88.012428099672377,2991.000000000000000,4,680,1,25.0000000,680,1,25.0000000,702,899
3637,4.000000000000000,0.000277777777778,489,1100,611,714.500000000000000,248.417491332635421,2858.000000000000000,4,489,1,25.0000000,489,1,25.0000000,503,1100
3638,3.000000000000000,0.000208333333333,563,774,211,669.333333333333371,86.148450685752636,2008.000000000000000,3,563,1,33.3333015,563,1,33.3333015,671,774
3639,4.000000000000000,0.000277777777778,120,556,436,343.250000000000000,174.527039452343899,1373.000000000000000,4,120,1,25.0000000,120,1,25.0000000,233,556
3640,5.000000000000000,0.000347222222222,120,1036,916,481.800000000000011,318.044273647553723,2409.000000000000000,5,120,1,20.0000000,120,1,20.0000000,464,1036
3641,4.000000000000000,0.000277777777778,688,2513,1825,1258.500000000000000,735.222585344057507,5034.000000000000000,4,688,1,25.0000000,688,1,25.0000000,796,2513
3642,4.000000000000000,0.000277777777778,234,1597,1363,678.250000000000000,537.130047102189224,2713.000000000000000,3,441,2,50.0000000,234,1,25.0000000,441,1597
3643,5.000000000000000,0.000347222222222,446,1802,1356,1394.200000000000045,490.076891926154815,6971.000000000000000,5,446,1,20.0000000,446,1,20.0000000,1637,1802
3644,4.000000000000000,0.000277777777778,1159,2502,1343,1720.750000000000000,519.139371941678064,6883.000000000000000,4,1159,1,25.0000000,1159,1,25.0000000,1358,2502
3645,4.000000000000000,0.000277777777778,1159,2502,1343,1720.750000000000000,519.139371941678064,6883.000000000000000,4,1159,1,25.0000000,1159,1,25.0000000,1358,2502
3646,3.000000000000000,0.000208333333333,901,2194,1293,1621.666666666666742,538.184809232747511,4865.000000000000000,3,901,1,33.3333015,901,1,33.3333015,1770,2194
3647,4.000000000000000,0.000277777777778,809,1597,788,1284.250000000000000,313.444871548411186,5137.000000000000000,4,809,1,25.0000000,809,1,25.0000000,1198,1597
3648,4.000000000000000,0.000277777777778,529,1168,639,940.000000000000000,245.341598592656112,3760.000000000000000,4,529,1,25.0000000,529,1,25.0000000,992,1168
3649,4.000000000000000,0.000277777777778,642,2916,2274,1764.750000000000000,867.005586775540905,7059.000000000000000,4,642,1,25.0000000,642,1,25.0000000,1292,2916
3650,4.000000000000000,0.000277777777778,291,4251,3960,1625.500000000000000,1559.269139693337138,6502.000000000000000,4,291,1,25.0000000,291,1,25.0000000,650,4251
3651,4.000000000000000,0.000277777777778,500,1946,1446,1201.000000000000000,515.741214176257245,4804.000000000000000,4,500,1,25.0000000,500,1,25.0000000,1088,1946
3652,4.000000000000000,0.000277777777778,500,1270,770,882.000000000000000,309.777339390730788,3528.000000000000000,4,500,1,25.0000000,500,1,25.0000000,670,1270
3653,4.000000000000000,0.000277777777778,1259,3287,2028,2015.250000000000000,763.049269379114207,8061.000000000000000,4,1259,1,25.0000000,1259,1,25.0000000,1699,3287
3654,4.000000000000000,0.000277777777778,28,349,321,127.500000000000000,129.823919213679574,510.000000000000000,4,28,1,25.0000000,28,1,25.0000000,44,349
3655,4.000000000000000,0.000277777777778,1676,4206,2530,2984.000000000000000,1046.584683625744674,11936.000000000000000,4,1676,1,25.0000000,1676,1,25.0000000,2261,4206
3656,4.000000000000000,0.000277777777778,968,2105,1137,1477.000000000000000,434.249352331123248,5908.000000000000000,4,968,1,25.0000000,968,1,25.0000000,1201,2105
3657,4.000000000000000,0.000277777777778,245,644,399,383.750000000000000,154.955437142424927,1535.000000000000000,4,245,1,25.0000000,245,1,25.0000000,294,644
3658,4.000000000000000,0.000277777777778,435,1112,677,655.250000000000000,267.604535649155252,2621.000000000000000,4,435,1,25.0000000,435,1,25.0000000,511,1112
3659,4.000000000000000,0.000277777777778,819,1422,603,1114.500000000000000,213.279745873817092,4458.000000000000000,4,819,1,25.0000000,819,1,25.0000000,1107,1422
3660,4.000000000000000,0.000277777777778,0,1026,1026,481.249999999999943,475.976561922958581,1925.000000000000000,4,0,1,25.0000000,0,1,25.0000000,16,1026
3661,4.000000000000000,0.000277777777778,73,494,421,275.250000000000000,189.303162942408335,1101.000000000000000,4,73,1,25.0000000,73,1,25.0000000,102,494
3662,4.000000000000000,0.000277777777778,568,2321,1753,1096.750000000000000,711.180840222794586,4387.000000000000000,4,568,1,25.0000000,568,1,25.0000000,711,2321
3663,5.000000000000000,0.000347222222222,796,2502,1706,1580.400000000000091,582.735823508388648,7902.000000000000000,5,796,1,20.0000000,796,1,20.0000000,1635,2502
3664,5.000000000000000,0.000347222222222,796,2502,1706,1577.400000000000091,582.485570636732632,7887.000000000000000,5,796,1,20.0000000,796,1,20.0000000,1620,2502
3665,4.000000000000000,0.000277777777778,35,134,99,68.500000000000000,39.651607785813681,274.000000000000000,4,35,1,25.0000000,35,1,25.0000000,39,134
3666,4.000000000000000,0.000277777777778,0,2028,2028,613.750000000000000,832.947289748877211,2455.000000000000000,4,0,1,25.0000000,0,1,25.0000000,16,2028
3667,4.000000000000000,0.000277777777778,0,2028,2028,613.750000000000000,832.947289748877211,2455.000000000000000,4,0,1,25.0000000,0,1,25.0000000,16,2028
3668,4.000000000000000,0.000277777777778,0,2028,2028,613.750000000000000,832.947289748877211,2455.000000000000000,4,0,1,25.0000000,0,1,25.0000000,16,2028
3669,4.000000000000000,0.000277777777778,0,2028,2028,613.750000000000000,832.947289748877211,2455.000000000000000,4,0,1,25.0000000,0,1,25.0000000,16,2028
3670,3.000000000000000,0.000208333333333,0,2028,2028,813.000000000000000,875.366209080519639,2439.000000000000000,3,0,1,33.3333015,0,1,33.3333015,411,2028
3671,4.000000000000000,0.000277777777778,862,3497,2635,1786.500000000000000,1035.433363379797584,7146.000000000000000,4,862,1,25.0000000,862,1,25.0000000,1078,3497
3672,3.000000000000000,0.000208333333333,307,1071,764,765.333333333333258,330.054877591927436,2296.000000000000000,3,307,1,33.3333015,307,1,33.3333015,918,1071
3673,3.000000000000000,0.000208333333333,790,2870,2080,1623.000000000000000,898.200794180603339,4869.000000000000000,3,790,1,33.3333015,790,1,33.3333015,1209,2870
3674,4.000000000000000,0.000277777777778,747,1638,891,1392.250000000000000,374.188705735488497,5569.000000000000000,4,747,1,25.0000000,747,1,25.0000000,1550,1638
3675,3.000000000000000,0.000208333333333,994,1422,428,1206.000000000000000,174.753159246597505,3618.000000000000000,3,994,1,33.3333015,994,1,33.3333015,1202,1422
3676,4.000000000000000,0.000277777777778,736,1655,919,1276.500000000000000,344.508708162798143,5106.000000000000000,4,736,1,25.0000000,736,1,25.0000000,1243,1655
3677,4.000000000000000,0.000277777777778,154,886,732,461.750000000000000,286.089474640364926,1847.000000000000000,4,154,1,25.0000000,154,1,25.0000000,252,886
3678,4.000000000000000,0.000277777777778,102,814,712,326.750000000000000,285.477998276574738,1307.000000000000000,4,102,1,25.0000000,102,1,25.0000000,153,814
3679,4.000000000000000,0.000277777777778,359,8111,7752,2738.250000000000000,3140.333531251099430,10953.000000000000000,4,359,1,25.0000000,359,1,25.0000000,773,8111
3680,4.000000000000000,0.000277777777778,931,2087,1156,1390.000000000000000,439.917605921836241,5560.000000000000000,4,931,1,25.0000000,931,1,25.0000000,1114,2087
3681,3.000000000000000,0.000208333333333,634,1788,1154,1048.333333333333258,524.283850176176543,3145.000000000000000,3,634,1,33.3333015,634,1,33.3333015,723,1788
3682,4.000000000000000,0.000277777777778,414,1741,1327,1144.750000000000000,523.991113951372313,4579.000000000000000,4,414,1,25.0000000,414,1,25.0000000,896,1741
3683,4.000000000000000,0.000277777777778,707,883,176,784.750000000000000,63.680354113337032,3139.000000000000000,4,707,1,25.0000000,707,1,25.0000000,762,883
3684,5.000000000000000,0.000347222222222,461,883,422,720.000000000000000,141.472258764748659,3600.000000000000000,5,461,1,20.0000000,461,1,20.0000000,762,883
3685,4.000000000000000,0.000277777777778,380,1070,690,793.500000000000000,257.151220102102570,3174.000000000000000,4,380,1,25.0000000,380,1,25.0000000,800,1070
3686,4.000000000000000,0.000277777777778,260,4086,3826,1547.500000000000000,1544.780647859106239,6190.000000000000000,4,260,1,25.0000000,260,1,25.0000000,347,4086
3687,4.000000000000000,0.000277777777778,751,2466,1715,1247.250000000000000,705.809597200264761,4989.000000000000000,4,751,1,25.0000000,751,1,25.0000000,881,2466
3688,5.000000000000000,0.000347222222222,28,750,722,305.199999999999989,262.722210709334604,1526.000000000000000,5,28,1,20.0000000,28,1,20.0000000,154,750
3689,4.000000000000000,0.000277777777778,597,1171,574,803.000000000000000,235.443199094813536,3212.000000000000000,4,597,1,25.0000000,597,1,25.0000000,598,1171
3690,4.000000000000000,0.000277777777778,26,512,486,388.750000000000000,209.453306252252787,1555.000000000000000,3,512,2,50.0000000,26,1,25.0000000,505,512
3691,4.000000000000000,0.000277777777778,688,1886,1198,1125.250000000000000,468.606111249095875,4501.000000000000000,4,688,1,25.0000000,688,1,25.0000000,796,1886
3692,4.000000000000000,0.000277777777778,688,2244,1556,1403.500000000000000,674.581907554597819,5614.000000000000000,4,688,1,25.0000000,688,1,25.0000000,796,2244
3693,3.000000000000000,0.000208333333333,688,1886,1198,1123.333333333333258,541.086150462402998,3370.000000000000000,3,688,1,33.3333015,688,1,33.3333015,796,1886
3694,4.000000000000000,0.000277777777778,795,1076,281,973.000000000000000,112.492221953342181,3892.000000000000000,4,795,1,25.0000000,795,1,25.0000000,958,1076
3695,4.000000000000000,0.000277777777778,642,2199,1557,1198.750000000000000,634.638627488116299,4795.000000000000000,4,642,1,25.0000000,642,1,25.0000000,659,2199
3696,4.000000000000000,0.000277777777778,541,1813,1272,1065.500000000000000,501.669462893646710,4262.000000000000000,4,541,1,25.0000000,541,1,25.0000000,682,1813
3697,4.000000000000000,0.000277777777778,398,1210,812,866.000000000000000,341.350259996971431,3464.000000000000000,4,398,1,25.0000000,398,1,25.0000000,682,1210
3698,4.000000000000000,0.000277777777778,1805,5460,3655,3544.000000000000000,1381.019007834432387,14176.000000000000000,4,1805,1,25.0000000,1805,1,25.0000000,2778,5460
3699,4.000000000000000,0.000277777777778,1805,5460,3655,3692.750000000000000,1465.885632476149112,14771.000000000000000,4,1805,1,25.0000000,1805,1,25.0000000,2778,5460
3700,5.000000000000000,0.000347222222222,545,1063,518,823.600000000000023,210.431556568875834,4118.000000000000000,5,545,1,20.0000000,545,1,20.0000000,893,1063
3701,4.000000000000000,0.000277777777778,3,2588,2585,953.000000000000000,1053.939039982863505,3812.000000000000000,4,3,1,25.0000000,3,1,25.0000000,48,2588
3702,3.000000000000000,0.000208333333333,910,1543,633,1280.333333333333485,269.402218913570835,3841.000000000000000,3,910,1,33.3333015,910,1,33.3333015,1388,1543
3703,4.000000000000000,0.000277777777778,587,1939,1352,1101.750000000000000,517.865511016132473,4407.000000000000000,4,587,1,25.0000000,587,1,25.0000000,775,1939
3704,4.000000000000000,0.000277777777778,769,1280,511,987.750000000000000,184.560796216314571,3951.000000000000000,4,769,1,25.0000000,769,1,25.0000000,939,1280
3705,4.000000000000000,0.000277777777778,694,1130,436,901.000000000000000,165.562676953472817,3604.000000000000000,4,694,1,25.0000000,694,1,25.0000000,806,1130
3706,4.000000000000000,0.000277777777778,355,1877,1522,1035.250000000000000,603.305219188430442,4141.000000000000000,4,355,1,25.0000000,355,1,25.0000000,586,1877
3707,4.000000000000000,0.000277777777778,737,1424,687,1084.500000000000000,253.913863347395818,4338.000000000000000,4,737,1,25.0000000,737,1,25.0000000,984,1424
3708,4.000000000000000,0.000277777777778,233,455,222,399.500000000000000,96.128819820072692,1598.000000000000000,2,455,3,75.0000000,233,1,25.0000000,455,455
3709,4.000000000000000,0.000277777777778,989,1570,581,1190.000000000000000,227.724614392032720,4760.000000000000000,4,989,1,25.0000000,989,1,25.0000000,1043,1570
3710,4.000000000000000,0.000277777777778,463,1518,1055,890.000000000000000,443.985923200274442,3560.000000000000000,4,463,1,25.0000000,463,1,25.0000000,480,1518
3711,4.000000000000000,0.000277777777778,182,1925,1743,706.500000000000000,707.954977382036645,2826.000000000000000,4,182,1,25.0000000,182,1,25.0000000,314,1925
3712,4.000000000000000,0.000277777777778,3,102,99,50.750000000000000,37.049797570297201,203.000000000000000,4,3,1,25.0000000,3,1,25.0000000,32,102
3713,4.000000000000000,0.000277777777778,671,1475,804,1013.500000000000000,332.854698029034921,4054.000000000000000,4,671,1,25.0000000,671,1,25.0000000,724,1475
3714,5.000000000000000,0.000347222222222,270,4005,3735,1477.400000000000091,1322.770667954199780,7387.000000000000000,5,270,1,20.0000000,270,1,20.0000000,844,4005
3715,4.000000000000000,0.000277777777778,1579,2459,880,1915.250000000000000,328.875641390480610,7661.000000000000000,4,1579,1,25.0000000,1579,1,25.0000000,1777,2459
3716,4.000000000000000,0.000277777777778,698,1808,1110,1361.750000000000000,408.674916651364867,5447.000000000000000,4,698,1,25.0000000,698,1,25.0000000,1422,1808
3717,5.000000000000000,0.000347222222222,446,2659,2213,1071.400000000000091,809.134994917411859,5357.000000000000000,5,446,1,20.0000000,446,1,20.0000000,798,2659
3718,5.000000000000000,0.000347222222222,446,2659,2213,1071.400000000000091,809.134994917411859,5357.000000000000000,5,446,1,20.0000000,446,1,20.0000000,798,2659
3719,4.000000000000000,0.000277777777778,894,4086,3192,2265.000000000000000,1151.253664489281846,9060.000000000000000,4,894,1,25.0000000,894,1,25.0000000,1992,4086
3720,4.000000000000000,0.000277777777778,608,1206,598,1032.250000000000000,246.878892374378580,4129.000000000000000,4,608,1,25.0000000,608,1,25.0000000,1124,1206
3721,4.000000000000000,0.000277777777778,1491,4340,2849,2291.750000000000000,1185.738667455860650,9167.000000000000000,4,1491,1,25.0000000,1491,1,25.0000000,1600,4340
3722,4.000000000000000,0.000277777777778,688,1574,886,1093.000000000000000,316.747533534201352,4372.000000000000000,4,688,1,25.0000000,688,1,25.0000000,1016,1574
3723,4.000000000000000,0.000277777777778,566,1358,792,916.250000000000000,293.550996421405443,3665.000000000000000,4,566,1,25.0000000,566,1,25.0000000,764,1358
3724,4.000000000000000,0.000277777777778,764,1009,245,922.250000000000000,94.666189846216994,3689.000000000000000,4,764,1,25.0000000,764,1,25.0000000,939,1009
3725,5.000000000000000,0.000347222222222,566,1358,792,934.799999999999955,265.168173052498901,4674.000000000000000,5,566,1,20.0000000,566,1,20.0000000,977,1358
3726,4.000000000000000,0.000277777777778,764,1009,245,922.250000000000000,94.666189846216994,3689.000000000000000,4,764,1,25.0000000,764,1,25.0000000,939,1009
3727,4.000000000000000,0.000277777777778,147,1055,908,499.250000000000000,337.047752551474503,1997.000000000000000,4,147,1,25.0000000,147,1,25.0000000,378,1055
3728,4.000000000000000,0.000277777777778,45,9194,9149,2711.500000000000000,3784.917469377635371,10846.000000000000000,4,45,1,25.0000000,45,1,25.0000000,137,9194
3729,4.000000000000000,0.000277777777778,804,2326,1522,1360.750000000000000,575.971950271886044,5443.000000000000000,4,804,1,25.0000000,804,1,25.0000000,1126,2326
3730,4.000000000000000,0.000277777777778,788,1532,744,1133.250000000000000,266.102776197468472,4533.000000000000000,4,788,1,25.0000000,788,1,25.0000000,1064,1532
3731,5.000000000000000,0.000347222222222,764,1251,487,1021.399999999999977,167.895920141020696,5107.000000000000000,5,764,1,20.0000000,764,1,20.0000000,1009,1251
3732,4.000000000000000,0.000277777777778,779,1589,810,1136.000000000000000,291.486706386414824,4544.000000000000000,4,779,1,25.0000000,779,1,25.0000000,1052,1589
3733,4.000000000000000,0.000277777777778,969,1251,282,1098.750000000000000,116.778369144289741,4395.000000000000000,4,969,1,25.0000000,969,1,25.0000000,1003,1251
3734,4.000000000000000,0.000277777777778,4133,5460,1327,4676.500000000000000,536.486020321126489,18706.000000000000000,4,4133,1,25.0000000,4133,1,25.0000000,4230,5460
3735,3.000000000000000,0.000208333333333,47,825,778,440.666666666666686,317.685728704048358,1322.000000000000000,3,47,1,33.3333015,47,1,33.3333015,450,825
3736,4.000000000000000,0.000277777777778,688,2513,1825,1560.250000000000000,824.643066726447387,6241.000000000000000,4,688,1,25.0000000,688,1,25.0000000,796,2513
3737,4.000000000000000,0.000277777777778,688,2244,1556,1403.500000000000000,674.581907554597819,5614.000000000000000,4,688,1,25.0000000,688,1,25.0000000,796,2244
3738,4.000000000000000,0.000277777777778,939,1401,462,1166.500000000000000,222.209923270766637,4666.000000000000000,4,939,1,25.0000000,939,1,25.0000000,950,1401
3739,4.000000000000000,0.000277777777778,1023,1387,364,1221.500000000000000,151.640199155764776,4886.000000000000000,4,1023,1,25.0000000,1023,1,25.0000000,1127,1387
3740,4.000000000000000,0.000277777777778,551,1987,1436,1031.500000000000000,565.496463295748640,4126.000000000000000,4,551,1,25.0000000,551,1,25.0000000,688,1987
3741,4.000000000000000,0.000277777777778,688,1987,1299,1155.000000000000000,496.849574821192675,4620.000000000000000,4,688,1,25.0000000,688,1,25.0000000,900,1987
3742,3.000000000000000,0.000208333333333,665,3590,2925,1668.666666666666742,1359.041410537425463,5006.000000000000000,3,665,1,33.3333015,665,1,33.3333015,751,3590
3743,4.000000000000000,0.000277777777778,369,1125,756,721.500000000000000,268.992100255750984,2886.000000000000000,4,369,1,25.0000000,369,1,25.0000000,673,1125
3744,3.000000000000000,0.000208333333333,974,3820,2846,1922.666666666666515,1341.617266171276242,5768.000000000000000,2,974,2,66.6667023,3820,1,33.3333015,974,3820
3745,4.000000000000000,0.000277777777778,488,3047,2559,1242.750000000000000,1047.044978737780866,4971.000000000000000,4,488,1,25.0000000,488,1,25.0000000,649,3047
3746,4.000000000000000,0.000277777777778,247,2107,1860,1394.750000000000000,694.176625578821927,5579.000000000000000,4,247,1,25.0000000,247,1,25.0000000,1549,2107
3747,4.000000000000000,0.000277777777778,494,1114,620,841.750000000000000,240.811518619853388,3367.000000000000000,4,494,1,25.0000000,494,1,25.0000000,749,1114
3748,4.000000000000000,0.000277777777778,232,3176,2944,1818.500000000000000,1345.109753886276849,7274.000000000000000,4,232,1,25.0000000,232,1,25.0000000,739,3176
3749,4.000000000000000,0.000277777777778,968,1927,959,1292.000000000000000,381.403329822905448,5168.000000000000000,4,968,1,25.0000000,968,1,25.0000000,1024,1927
3750,4.000000000000000,0.000277777777778,487,1568,1081,875.500000000000000,418.796191482205359,3502.000000000000000,4,487,1,25.0000000,487,1,25.0000000,612,1568
3751,4.000000000000000,0.000277777777778,637,2721,2084,1812.500000000000000,776.559559853589121,7250.000000000000000,4,637,1,25.0000000,637,1,25.0000000,1655,2721
3752,4.000000000000000,0.000277777777778,471,1385,914,756.750000000000000,366.130014475732366,3027.000000000000000,4,471,1,25.0000000,471,1,25.0000000,561,1385
3753,4.000000000000000,0.000277777777778,364,1262,898,882.000000000000000,362.076649343754298,3528.000000000000000,4,364,1,25.0000000,364,1,25.0000000,725,1262
3754,5.000000000000000,0.000347222222222,328,2028,1700,696.000000000000000,666.569426241558062,3480.000000000000000,5,328,1,20.0000000,328,1,20.0000000,369,2028
3755,5.000000000000000,0.000347222222222,81,1104,1023,626.799999999999955,407.380608276830003,3134.000000000000000,5,81,1,20.0000000,81,1,20.0000000,449,1104
3756,4.000000000000000,0.000277777777778,81,1104,1023,683.000000000000000,437.785906579917196,2732.000000000000000,4,81,1,25.0000000,81,1,25.0000000,449,1104
3757,4.000000000000000,0.000277777777778,526,2039,1513,1209.500000000000000,571.594480379228344,4838.000000000000000,4,526,1,25.0000000,526,1,25.0000000,871,2039
3758,4.000000000000000,0.000277777777778,427,1380,953,747.000000000000000,374.472295370431937,2988.000000000000000,4,427,1,25.0000000,427,1,25.0000000,524,1380
3759,4.000000000000000,0.000277777777778,427,1380,953,747.000000000000000,374.472295370431937,2988.000000000000000,4,427,1,25.0000000,427,1,25.0000000,524,1380
3760,4.000000000000000,0.000277777777778,618,1044,426,786.500000000000000,179.183565094569985,3146.000000000000000,4,618,1,25.0000000,618,1,25.0000000,620,1044
3761,3.000000000000000,0.000208333333333,504,791,287,672.000000000000000,122.182922974803091,2016.000000000000000,3,504,1,33.3333015,504,1,33.3333015,721,791
3762,4.000000000000000,0.000277777777778,504,791,287,663.500000000000000,106.832813311266861,2654.000000000000000,4,504,1,25.0000000,504,1,25.0000000,638,791
3763,4.000000000000000,0.000277777777778,504,721,217,612.250000000000000,78.893520012736161,2449.000000000000000,4,504,1,25.0000000,504,1,25.0000000,586,721
3764,4.000000000000000,0.000277777777778,185,762,577,464.000000000000000,271.264630941816677,1856.000000000000000,4,185,1,25.0000000,185,1,25.0000000,202,762
3765,4.000000000000000,0.000277777777778,707,883,176,784.750000000000000,63.680354113337032,3139.000000000000000,4,707,1,25.0000000,707,1,25.0000000,762,883
3766,4.000000000000000,0.000277777777778,672,1038,366,901.000000000000000,138.378105204544539,3604.000000000000000,4,672,1,25.0000000,672,1,25.0000000,923,1038
3767,4.000000000000000,0.000277777777778,968,1927,959,1347.750000000000000,387.295994686234792,5391.000000000000000,4,968,1,25.0000000,968,1,25.0000000,1024,1927
3768,4.000000000000000,0.000277777777778,596,1349,753,929.750000000000000,325.158711247292274,3719.000000000000000,4,596,1,25.0000000,596,1,25.0000000,630,1349
3769,4.000000000000000,0.000277777777778,733,2026,1293,1406.000000000000000,461.702826502069399,5624.000000000000000,4,733,1,25.0000000,733,1,25.0000000,1349,2026
3770,4.000000000000000,0.000277777777778,750,1777,1027,1286.750000000000000,377.069870846239837,5147.000000000000000,4,750,1,25.0000000,750,1,25.0000000,1170,1777
3771,4.000000000000000,0.000277777777778,1150,3986,2836,1874.500000000000000,1219.325325743708163,7498.000000000000000,4,1150,1,25.0000000,1150,1,25.0000000,1151,3986
3772,4.000000000000000,0.000277777777778,596,1342,746,1096.750000000000000,299.375495824224060,4387.000000000000000,4,596,1,25.0000000,596,1,25.0000000,1138,1342
3773,4.000000000000000,0.000277777777778,368,904,536,648.500000000000000,216.841531999753215,2594.000000000000000,4,368,1,25.0000000,368,1,25.0000000,513,904
3774,3.000000000000000,0.000208333333333,368,809,441,563.333333333333371,183.521721390745000,1690.000000000000000,3,368,1,33.3333015,368,1,33.3333015,513,809
3775,4.000000000000000,0.000277777777778,312,817,505,580.250000000000000,179.288001550577832,2321.000000000000000,4,312,1,25.0000000,312,1,25.0000000,590,817
3776,4.000000000000000,0.000277777777778,324,897,573,716.000000000000000,231.295265840008085,2864.000000000000000,4,324,1,25.0000000,324,1,25.0000000,770,897
3777,3.000000000000000,0.000208333333333,511,1239,728,884.000000000000000,297.477169992365418,2652.000000000000000,3,511,1,33.3333015,511,1,33.3333015,902,1239
3778,4.000000000000000,0.000277777777778,774,1176,402,923.250000000000000,154.352478114217519,3693.000000000000000,4,774,1,25.0000000,774,1,25.0000000,828,1176
3779,4.000000000000000,0.000277777777778,1099,1259,160,1158.750000000000000,66.258490022034138,4635.000000000000000,3,1099,2,50.0000000,1178,1,25.0000000,1099,1259
3780,4.000000000000000,0.000277777777778,56,2745,2689,1778.750000000000000,1026.413994205067411,7115.000000000000000,4,56,1,25.0000000,56,1,25.0000000,2042,2745
3781,4.000000000000000,0.000277777777778,238,1476,1238,594.750000000000000,510.383862891451543,2379.000000000000000,4,238,1,25.0000000,238,1,25.0000000,316,1476
3782,4.000000000000000,0.000277777777778,527,2932,2405,1136.500000000000000,1036.661588947907376,4546.000000000000000,4,527,1,25.0000000,527,1,25.0000000,538,2932
3783,4.000000000000000,0.000277777777778,420,1257,837,702.500000000000000,325.702701861682442,2810.000000000000000,4,420,1,25.0000000,420,1,25.0000000,561,1257
3784,4.000000000000000,0.000277777777778,768,2056,1288,1547.000000000000000,503.899791625279363,6188.000000000000000,4,768,1,25.0000000,768,1,25.0000000,1444,2056
3785,4.000000000000000,0.000277777777778,742,2664,1922,1757.750000000000000,817.288925350148133,7031.000000000000000,4,742,1,25.0000000,742,1,25.0000000,1175,2664
3786,4.000000000000000,0.000277777777778,441,3379,2938,1523.750000000000000,1145.253547254930027,6095.000000000000000,4,441,1,25.0000000,441,1,25.0000000,729,3379
3787,4.000000000000000,0.000277777777778,860,1913,1053,1265.750000000000000,408.607008628094889,5063.000000000000000,4,860,1,25.0000000,860,1,25.0000000,979,1913
3788,5.000000000000000,0.000347222222222,441,1803,1362,1200.600000000000136,509.357870264119924,6003.000000000000000,5,441,1,20.0000000,441,1,20.0000000,1083,1803
3789,4.000000000000000,0.000277777777778,671,2119,1448,1326.000000000000000,631.215890167540010,5304.000000000000000,4,671,1,25.0000000,671,1,25.0000000,744,2119
3790,4.000000000000000,0.000277777777778,671,2119,1448,1326.000000000000000,631.215890167540010,5304.000000000000000,4,671,1,25.0000000,671,1,25.0000000,744,2119
3791,4.000000000000000,0.000277777777778,871,1628,757,1227.000000000000000,302.721819497703223,4908.000000000000000,4,871,1,25.0000000,871,1,25.0000000,1007,1628
3792,4.000000000000000,0.000277777777778,871,2039,1168,1329.750000000000000,453.562220097750185,5319.000000000000000,4,871,1,25.0000000,871,1,25.0000000,1007,2039
3793,4.000000000000000,0.000277777777778,909,1308,399,1142.500000000000000,165.822947748494698,4570.000000000000000,4,909,1,25.0000000,909,1,25.0000000,1063,1308
3794,5.000000000000000,0.000347222222222,918,1472,554,1179.000000000000000,206.375386129257208,5895.000000000000000,5,918,1,20.0000000,918,1,20.0000000,1101,1472
3795,4.000000000000000,0.000277777777778,831,1600,769,1249.750000000000000,310.672959074329469,4999.000000000000000,4,831,1,25.0000000,831,1,25.0000000,1077,1600
3796,5.000000000000000,0.000347222222222,168,1877,1709,946.000000000000000,627.244131100483060,4730.000000000000000,5,168,1,20.0000000,168,1,20.0000000,1007,1877
3797,4.000000000000000,0.000277777777778,1107,3298,2191,1906.500000000000000,901.624228822628766,7626.000000000000000,4,1107,1,25.0000000,1107,1,25.0000000,1110,3298
3798,4.000000000000000,0.000277777777778,943,2121,1178,1543.500000000000000,428.407808052094254,6174.000000000000000,4,943,1,25.0000000,943,1,25.0000000,1414,2121
3799,3.000000000000000,0.000208333333333,952,4820,3868,2558.333333333333485,1645.691816700671097,7675.000000000000000,3,952,1,33.3333015,952,1,33.3333015,1903,4820
3800,4.000000000000000,0.000277777777778,1865,2281,416,2079.250000000000000,172.624411657216058,8317.000000000000000,4,1865,1,25.0000000,1865,1,25.0000000,1958,2281
3801,4.000000000000000,0.000277777777778,979,1428,449,1143.500000000000000,169.868331362852928,4574.000000000000000,4,979,1,25.0000000,979,1,25.0000000,1073,1428
3802,4.000000000000000,0.000277777777778,453,1354,901,935.750000000000000,334.514106578481972,3743.000000000000000,4,453,1,25.0000000,453,1,25.0000000,831,1354
3803,4.000000000000000,0.000277777777778,453,1354,901,935.750000000000000,334.514106578481972,3743.000000000000000,4,453,1,25.0000000,453,1,25.0000000,831,1354
3804,4.000000000000000,0.000277777777778,453,1354,901,935.750000000000000,334.514106578481972,3743.000000000000000,4,453,1,25.0000000,453,1,25.0000000,831,1354
3805,4.000000000000000,0.000277777777778,453,1354,901,935.750000000000000,334.514106578481972,3743.000000000000000,4,453,1,25.0000000,453,1,25.0000000,831,1354
3806,4.000000000000000,0.000277777777778,453,2121,1668,1258.250000000000000,596.954510410969192,5033.000000000000000,4,453,1,25.0000000,453,1,25.0000000,1105,2121
3807,5.000000000000000,0.000347222222222,565,1472,907,1031.200000000000045,352.651896351061794,5156.000000000000000,5,565,1,20.0000000,565,1,20.0000000,1041,1472
3808,4.000000000000000,0.000277777777778,545,1063,518,777.000000000000000,210.936009253991529,3108.000000000000000,4,545,1,25.0000000,545,1,25.0000000,607,1063
3809,3.000000000000000,0.000208333333333,1018,1046,28,1030.333333333333258,11.671427600007730,3091.000000000000000,3,1018,1,33.3333015,1018,1,33.3333015,1027,1046
3810,5.000000000000000,0.000347222222222,1202,3559,2357,2201.400000000000091,892.689554100416217,11007.000000000000000,5,1202,1,20.0000000,1202,1,20.0000000,1673,3559
3811,4.000000000000000,0.000277777777778,329,1628,1299,1153.250000000000000,524.407463238272385,4613.000000000000000,4,329,1,25.0000000,329,1,25.0000000,1069,1628
3812,4.000000000000000,0.000277777777778,604,3312,2708,2113.750000000000000,1080.609636964246192,8455.000000000000000,4,604,1,25.0000000,604,1,25.0000000,1596,3312
3813,4.000000000000000,0.000277777777778,441,1729,1288,1033.000000000000000,459.865741276733957,4132.000000000000000,4,441,1,25.0000000,441,1,25.0000000,928,1729
3814,4.000000000000000,0.000277777777778,729,1542,813,1287.000000000000000,333.060805259339986,5148.000000000000000,3,1542,2,50.0000000,729,1,25.0000000,1335,1542
3815,4.000000000000000,0.000277777777778,772,1969,1197,1477.250000000000000,438.799142547019983,5909.000000000000000,4,772,1,25.0000000,772,1,25.0000000,1520,1969
3816,3.000000000000000,0.000208333333333,716,1071,355,895.000000000000000,144.943667218221947,2685.000000000000000,3,716,1,33.3333015,716,1,33.3333015,898,1071
3817,3.000000000000000,0.000208333333333,878,1758,880,1254.666666666666742,370.255167268316313,3764.000000000000000,3,878,1,33.3333015,878,1,33.3333015,1128,1758
3818,4.000000000000000,0.000277777777778,664,1758,1094,1107.000000000000000,410.162163052615085,4428.000000000000000,4,664,1,25.0000000,664,1,25.0000000,878,1758
3819,3.000000000000000,0.000208333333333,526,1511,985,894.000000000000000,438.981396720483644,2682.000000000000000,3,526,1,33.3333015,526,1,33.3333015,645,1511
3820,5.000000000000000,0.000347222222222,225,1680,1455,711.600000000000023,560.415774224816118,3558.000000000000000,5,225,1,20.0000000,225,1,20.0000000,373,1680
3821,3.000000000000000,0.000208333333333,261,302,41,285.666666666666686,17.745108872274887,857.000000000000000,3,261,1,33.3333015,261,1,33.3333015,294,302
3822,4.000000000000000,0.000277777777778,73,746,673,439.750000000000000,240.456207031550775,1759.000000000000000,4,73,1,25.0000000,73,1,25.0000000,446,746
3823,4.000000000000000,0.000277777777778,688,1574,886,1030.250000000000000,349.005999232104898,4121.000000000000000,4,688,1,25.0000000,688,1,25.0000000,765,1574
3824,4.000000000000000,0.000277777777778,798,2659,1861,1290.750000000000000,790.602420626195681,5163.000000000000000,4,798,1,25.0000000,798,1,25.0000000,821,2659
3825,4.000000000000000,0.000277777777778,1088,3083,1995,2184.250000000000000,838.192810455923677,8737.000000000000000,4,1088,1,25.0000000,1088,1,25.0000000,1658,3083
3826,4.000000000000000,0.000277777777778,1140,2432,1292,1754.000000000000000,575.934023999277201,7016.000000000000000,4,1140,1,25.0000000,1140,1,25.0000000,1228,2432
3827,4.000000000000000,0.000277777777778,383,1405,1022,832.750000000000000,374.722814224060812,3331.000000000000000,4,383,1,25.0000000,383,1,25.0000000,661,1405
3828,4.000000000000000,0.000277777777778,761,1358,597,1024.250000000000000,215.263065805539441,4097.000000000000000,4,761,1,25.0000000,761,1,25.0000000,956,1358
3829,4.000000000000000,0.000277777777778,419,1512,1093,959.500000000000000,392.214545880185312,3838.000000000000000,4,419,1,25.0000000,419,1,25.0000000,859,1512
3830,4.000000000000000,0.000277777777778,402,1098,696,646.000000000000000,269.963886473728166,2584.000000000000000,4,402,1,25.0000000,402,1,25.0000000,487,1098
3831,4.000000000000000,0.000277777777778,635,3008,2373,1504.000000000000000,912.245855019358260,6016.000000000000000,4,635,1,25.0000000,635,1,25.0000000,952,3008
3832,4.000000000000000,0.000277777777778,856,1376,520,1010.750000000000000,214.167428662717072,4043.000000000000000,4,856,1,25.0000000,856,1,25.0000000,861,1376
3833,4.000000000000000,0.000277777777778,258,2464,2206,1275.750000000000000,816.659162380487828,5103.000000000000000,4,258,1,25.0000000,258,1,25.0000000,870,2464
3834,5.000000000000000,0.000347222222222,658,2171,1513,1289.599999999999909,629.454557533742900,6448.000000000000000,5,658,1,20.0000000,658,1,20.0000000,999,2171
3835,4.000000000000000,0.000277777777778,78,969,891,592.750000000000000,322.984035983204592,2371.000000000000000,4,78,1,25.0000000,78,1,25.0000000,638,969
3836,4.000000000000000,0.000277777777778,544,1308,764,775.500000000000000,312.206261948731594,3102.000000000000000,4,544,1,25.0000000,544,1,25.0000000,564,1308
3837,4.000000000000000,0.000277777777778,174,3955,3781,1634.250000000000000,1412.908414406255815,6537.000000000000000,4,174,1,25.0000000,174,1,25.0000000,984,3955
3838,4.000000000000000,0.000277777777778,638,1574,936,1080.500000000000000,333.050671820370326,4322.000000000000000,4,638,1,25.0000000,638,1,25.0000000,1016,1574
3839,5.000000000000000,0.000347222222222,795,2647,1852,1307.799999999999955,677.117242432948160,6539.000000000000000,5,795,1,20.0000000,795,1,20.0000000,1063,2647
3840,3.000000000000000,0.000208333333333,849,1715,866,1284.333333333333258,353.558418872405809,3853.000000000000000,3,849,1,33.3333015,849,1,33.3333015,1289,1715
3841,4.000000000000000,0.000277777777778,871,1639,768,1170.750000000000000,284.484072489129005,4683.000000000000000,4,871,1,25.0000000,871,1,25.0000000,1072,1639
3842,4.000000000000000,0.000277777777778,726,955,229,867.000000000000000,95.013156983651484,3468.000000000000000,4,726,1,25.0000000,726,1,25.0000000,834,955
3843,4.000000000000000,0.000277777777778,1157,2334,1177,1514.000000000000000,478.303773767257667,6056.000000000000000,4,1157,1,25.0000000,1157,1,25.0000000,1219,2334
3844,4.000000000000000,0.000277777777778,1157,2334,1177,1514.000000000000000,478.303773767257667,6056.000000000000000,4,1157,1,25.0000000,1157,1,25.0000000,1219,2334
3845,4.000000000000000,0.000277777777778,1157,2334,1177,1514.000000000000000,478.303773767257667,6056.000000000000000,4,1157,1,25.0000000,1157,1,25.0000000,1219,2334
3846,4.000000000000000,0.000277777777778,297,1070,773,689.750000000000000,280.050330297966241,2759.000000000000000,4,297,1,25.0000000,297,1,25.0000000,610,1070
3847,4.000000000000000,0.000277777777778,959,1544,585,1220.250000000000000,242.320423200356771,4881.000000000000000,4,959,1,25.0000000,959,1,25.0000000,1016,1544
3848,4.000000000000000,0.000277777777778,678,4119,3441,2032.500000000000000,1403.181830697647001,8130.000000000000000,4,678,1,25.0000000,678,1,25.0000000,824,4119
3849,4.000000000000000,0.000277777777778,573,2846,2273,1219.750000000000000,942.799653956236853,4879.000000000000000,4,573,1,25.0000000,573,1,25.0000000,650,2846
3850,4.000000000000000,0.000277777777778,561,1167,606,880.250000000000000,219.953830382650978,3521.000000000000000,4,561,1,25.0000000,561,1,25.0000000,830,1167
3851,4.000000000000000,0.000277777777778,150,2335,2185,1377.750000000000000,815.474516769224465,5511.000000000000000,4,150,1,25.0000000,150,1,25.0000000,1197,2335
3852,4.000000000000000,0.000277777777778,150,1829,1679,1102.250000000000000,604.363042797952744,4409.000000000000000,4,150,1,25.0000000,150,1,25.0000000,1197,1829
3853,4.000000000000000,0.000277777777778,266,924,658,535.250000000000000,240.864458772978793,2141.000000000000000,4,266,1,25.0000000,266,1,25.0000000,450,924
3854,4.000000000000000,0.000277777777778,504,726,222,615.500000000000000,86.378527424354701,2462.000000000000000,4,504,1,25.0000000,504,1,25.0000000,565,726
3855,5.000000000000000,0.000347222222222,640,1036,396,766.200000000000045,138.927894967137547,3831.000000000000000,5,640,1,20.0000000,640,1,20.0000000,727,1036
3856,4.000000000000000,0.000277777777778,649,1994,1345,1511.000000000000000,513.140818879184508,6044.000000000000000,4,649,1,25.0000000,649,1,25.0000000,1650,1994
3857,5.000000000000000,0.000347222222222,839,2246,1407,1357.599999999999909,511.173003982017804,6788.000000000000000,5,839,1,20.0000000,839,1,20.0000000,1391,2246
3858,4.000000000000000,0.000277777777778,887,1246,359,1111.500000000000000,146.479520752902516,4446.000000000000000,4,887,1,25.0000000,887,1,25.0000000,1075,1246
3859,5.000000000000000,0.000347222222222,1032,1135,103,1085.599999999999909,41.869320510368929,5428.000000000000000,5,1032,1,20.0000000,1032,1,20.0000000,1088,1135
3860,4.000000000000000,0.000277777777778,779,1529,750,1040.250000000000000,289.447210212846926,4161.000000000000000,4,779,1,25.0000000,779,1,25.0000000,894,1529
3861,4.000000000000000,0.000277777777778,779,1529,750,1040.250000000000000,289.447210212846926,4161.000000000000000,4,779,1,25.0000000,779,1,25.0000000,894,1529
3862,4.000000000000000,0.000277777777778,779,1529,750,1040.250000000000000,289.447210212846926,4161.000000000000000,4,779,1,25.0000000,779,1,25.0000000,894,1529
3863,4.000000000000000,0.000277777777778,827,1608,781,1242.000000000000000,300.080822446220338,4968.000000000000000,4,827,1,25.0000000,827,1,25.0000000,1104,1608
3864,4.000000000000000,0.000277777777778,320,610,290,508.750000000000000,118.417429038127665,2035.000000000000000,4,320,1,25.0000000,320,1,25.0000000,496,610
3865,4.000000000000000,0.000277777777778,966,2430,1464,1439.000000000000000,592.767661061228978,5756.000000000000000,4,966,1,25.0000000,966,1,25.0000000,999,2430
3866,4.000000000000000,0.000277777777778,504,2046,1542,1179.500000000000000,590.986674976686800,4718.000000000000000,4,504,1,25.0000000,504,1,25.0000000,791,2046
3867,4.000000000000000,0.000277777777778,355,1394,1039,1102.000000000000000,432.303712683571575,4408.000000000000000,4,355,1,25.0000000,355,1,25.0000000,1310,1394
3868,4.000000000000000,0.000277777777778,695,1388,693,1029.750000000000000,287.473803154304846,4119.000000000000000,4,695,1,25.0000000,695,1,25.0000000,806,1388
3869,3.000000000000000,0.000208333333333,168,923,755,576.333333333333258,311.296571705432655,1729.000000000000000,3,168,1,33.3333015,168,1,33.3333015,638,923
3870,4.000000000000000,0.000277777777778,343,1550,1207,893.500000000000000,430.791422848691411,3574.000000000000000,4,343,1,25.0000000,343,1,25.0000000,804,1550
3871,4.000000000000000,0.000277777777778,45,9194,9149,2711.500000000000000,3784.917469377635371,10846.000000000000000,4,45,1,25.0000000,45,1,25.0000000,137,9194
3872,3.000000000000000,0.000208333333333,976,1795,819,1344.333333333333258,339.386046986155407,4033.000000000000000,3,976,1,33.3333015,976,1,33.3333015,1262,1795
3873,3.000000000000000,0.000208333333333,341,864,523,653.000000000000000,225.141437027186669,1959.000000000000000,3,341,1,33.3333015,341,1,33.3333015,754,864
3874,4.000000000000000,0.000277777777778,561,605,44,581.000000000000000,16.673332000533065,2324.000000000000000,4,561,1,25.0000000,561,1,25.0000000,571,605
3875,5.000000000000000,0.000347222222222,165,605,440,462.000000000000000,163.251952515123065,2310.000000000000000,5,165,1,20.0000000,165,1,20.0000000,561,605
3876,4.000000000000000,0.000277777777778,523,898,375,698.750000000000000,133.109682217335319,2795.000000000000000,4,523,1,25.0000000,523,1,25.0000000,685,898
3877,4.000000000000000,0.000277777777778,523,898,375,698.750000000000000,133.109682217335319,2795.000000000000000,4,523,1,25.0000000,523,1,25.0000000,685,898
3878,4.000000000000000,0.000277777777778,75,284,209,155.750000000000000,83.103474656599047,623.000000000000000,4,75,1,25.0000000,75,1,25.0000000,90,284
3879,3.000000000000000,0.000208333333333,641,5838,5197,2611.000000000000000,2300.324469866515756,7833.000000000000000,3,641,1,33.3333015,641,1,33.3333015,1354,5838
3880,4.000000000000000,0.000277777777778,1081,2335,1254,1600.750000000000000,508.712283614225328,6403.000000000000000,4,1081,1,25.0000000,1081,1,25.0000000,1175,2335
3881,4.000000000000000,0.000277777777778,171,1128,957,662.000000000000000,458.628934979030703,2648.000000000000000,4,171,1,25.0000000,171,1,25.0000000,237,1128
3882,4.000000000000000,0.000277777777778,171,1128,957,662.000000000000000,458.628934979030703,2648.000000000000000,4,171,1,25.0000000,171,1,25.0000000,237,1128
3883,5.000000000000000,0.000347222222222,329,943,614,592.600000000000023,251.731285302403421,2963.000000000000000,5,329,1,20.0000000,329,1,20.0000000,527,943
3884,4.000000000000000,0.000277777777778,38,1149,1111,395.250000000000000,452.266721636690818,1581.000000000000000,4,38,1,25.0000000,38,1,25.0000000,49,1149
3885,4.000000000000000,0.000277777777778,688,2008,1320,1156.500000000000000,517.139004523928747,4626.000000000000000,4,688,1,25.0000000,688,1,25.0000000,804,2008
3886,4.000000000000000,0.000277777777778,472,1160,688,738.250000000000000,276.384130333128951,2953.000000000000000,4,472,1,25.0000000,472,1,25.0000000,511,1160
3887,4.000000000000000,0.000277777777778,472,1160,688,738.250000000000000,276.384130333128951,2953.000000000000000,4,472,1,25.0000000,472,1,25.0000000,511,1160
3888,4.000000000000000,0.000277777777778,893,2606,1713,1672.250000000000000,614.228123338552450,6689.000000000000000,4,893,1,25.0000000,893,1,25.0000000,1500,2606
3889,4.000000000000000,0.000277777777778,249,1802,1553,761.500000000000000,623.348417821044904,3046.000000000000000,4,249,1,25.0000000,249,1,25.0000000,311,1802
3890,4.000000000000000,0.000277777777778,767,1430,663,1144.000000000000000,278.787553524184432,4576.000000000000000,4,767,1,25.0000000,767,1,25.0000000,986,1430
3891,5.000000000000000,0.000347222222222,654,1430,776,1082.200000000000045,292.636566409599595,5411.000000000000000,5,654,1,20.0000000,654,1,20.0000000,986,1430
3892,4.000000000000000,0.000277777777778,427,3107,2680,1201.500000000000000,1111.088767830905681,4806.000000000000000,4,427,1,25.0000000,427,1,25.0000000,452,3107
3893,4.000000000000000,0.000277777777778,312,1172,860,695.500000000000000,346.626960867154708,2782.000000000000000,4,312,1,25.0000000,312,1,25.0000000,423,1172
3894,3.000000000000000,0.000208333333333,688,2008,1320,1274.000000000000000,548.955371592263418,3822.000000000000000,3,688,1,33.3333015,688,1,33.3333015,1126,2008
3895,3.000000000000000,0.000208333333333,222,684,462,473.000000000000000,190.719689597062853,1419.000000000000000,3,222,1,33.3333015,222,1,33.3333015,513,684
3896,4.000000000000000,0.000277777777778,222,684,462,494.250000000000000,195.223429690188567,1977.000000000000000,4,222,1,25.0000000,222,1,25.0000000,396,684
3897,4.000000000000000,0.000277777777778,222,684,462,494.250000000000000,195.223429690188567,1977.000000000000000,4,222,1,25.0000000,222,1,25.0000000,396,684
3898,3.000000000000000,0.000208333333333,198,684,486,368.000000000000000,223.660456943108301,1104.000000000000000,3,198,1,33.3333015,198,1,33.3333015,222,684
3899,4.000000000000000,0.000277777777778,616,2456,1840,1330.000000000000000,683.827829208493085,5320.000000000000000,4,616,1,25.0000000,616,1,25.0000000,1061,2456
3900,4.000000000000000,0.000277777777778,616,2456,1840,1330.000000000000000,683.827829208493085,5320.000000000000000,4,616,1,25.0000000,616,1,25.0000000,1061,2456
3901,4.000000000000000,0.000277777777778,596,1342,746,1096.750000000000000,299.375495824224060,4387.000000000000000,4,596,1,25.0000000,596,1,25.0000000,1138,1342
3902,4.000000000000000,0.000277777777778,831,1666,835,1118.000000000000000,324.822259089490331,4472.000000000000000,4,831,1,25.0000000,831,1,25.0000000,936,1666
3903,4.000000000000000,0.000277777777778,822,2192,1370,1635.250000000000000,568.393074817067031,6541.000000000000000,4,822,1,25.0000000,822,1,25.0000000,1384,2192
3904,5.000000000000000,0.000347222222222,552,943,391,704.200000000000045,145.406189689435166,3521.000000000000000,5,552,1,20.0000000,552,1,20.0000000,620,943
3905,4.000000000000000,0.000277777777778,357,778,421,486.000000000000000,169.780740957271121,1944.000000000000000,4,357,1,25.0000000,357,1,25.0000000,397,778
3906,4.000000000000000,0.000277777777778,468,1498,1030,1038.250000000000000,368.402208869599463,4153.000000000000000,4,468,1,25.0000000,468,1,25.0000000,1083,1498
3907,4.000000000000000,0.000277777777778,1026,2819,1793,1739.250000000000000,661.193759423060442,6957.000000000000000,4,1026,1,25.0000000,1026,1,25.0000000,1497,2819
3908,4.000000000000000,0.000277777777778,359,1002,643,608.250000000000000,263.707579527020812,2433.000000000000000,4,359,1,25.0000000,359,1,25.0000000,377,1002
3909,4.000000000000000,0.000277777777778,801,1831,1030,1280.500000000000000,424.001474054041466,5122.000000000000000,4,801,1,25.0000000,801,1,25.0000000,942,1831
3910,3.000000000000000,0.000208333333333,444,649,205,541.666666666666629,83.969571208199511,1625.000000000000000,3,444,1,33.3333015,444,1,33.3333015,532,649
3911,4.000000000000000,0.000277777777778,760,1399,639,1139.750000000000000,241.595089974941374,4559.000000000000000,4,760,1,25.0000000,760,1,25.0000000,1114,1399
3912,4.000000000000000,0.000277777777778,559,1429,870,829.500000000000000,355.771345108062349,3318.000000000000000,4,559,1,25.0000000,559,1,25.0000000,566,1429
3913,4.000000000000000,0.000277777777778,559,977,418,716.500000000000000,171.444597465187002,2866.000000000000000,4,559,1,25.0000000,559,1,25.0000000,566,977
3914,5.000000000000000,0.000347222222222,508,1789,1281,1167.400000000000091,528.941433430961183,5837.000000000000000,5,508,1,20.0000000,508,1,20.0000000,1198,1789
3915,4.000000000000000,0.000277777777778,680,1143,463,910.000000000000000,164.022864259834222,3640.000000000000000,4,680,1,25.0000000,680,1,25.0000000,894,1143
3916,5.000000000000000,0.000347222222222,313,1054,741,730.200000000000045,252.052692903686335,3651.000000000000000,5,313,1,20.0000000,313,1,20.0000000,706,1054
3917,4.000000000000000,0.000277777777778,489,1500,1011,918.750000000000000,432.397603485495722,3675.000000000000000,4,489,1,25.0000000,489,1,25.0000000,516,1500
3918,4.000000000000000,0.000277777777778,489,1500,1011,1053.000000000000000,364.552465359925918,4212.000000000000000,4,489,1,25.0000000,489,1,25.0000000,1053,1500
3919,4.000000000000000,0.000277777777778,489,1500,1011,1073.000000000000000,372.529864574640499,4292.000000000000000,4,489,1,25.0000000,489,1,25.0000000,1053,1500
3920,5.000000000000000,0.000347222222222,311,677,366,575.200000000000045,138.104887675997901,2876.000000000000000,5,311,1,20.0000000,311,1,20.0000000,647,677
3921,4.000000000000000,0.000277777777778,736,1635,899,1185.500000000000000,329.436260906415669,4742.000000000000000,4,736,1,25.0000000,736,1,25.0000000,1063,1635
3922,4.000000000000000,0.000277777777778,274,1661,1387,1104.750000000000000,535.650247362959817,4419.000000000000000,4,274,1,25.0000000,274,1,25.0000000,1007,1661
3923,4.000000000000000,0.000277777777778,366,1424,1058,761.000000000000000,397.367588008886287,3044.000000000000000,4,366,1,25.0000000,366,1,25.0000000,620,1424
3924,4.000000000000000,0.000277777777778,342,810,468,583.750000000000000,166.160126083245387,2335.000000000000000,4,342,1,25.0000000,342,1,25.0000000,573,810
3925,4.000000000000000,0.000277777777778,453,2302,1849,1557.500000000000000,730.264506874050426,6230.000000000000000,4,453,1,25.0000000,453,1,25.0000000,1354,2302
3926,4.000000000000000,0.000277777777778,1056,1696,640,1453.500000000000000,259.126899414167326,5814.000000000000000,4,1056,1,25.0000000,1056,1,25.0000000,1390,1696
3927,4.000000000000000,0.000277777777778,967,1488,521,1192.500000000000000,190.736074196781146,4770.000000000000000,4,967,1,25.0000000,967,1,25.0000000,1108,1488
3928,4.000000000000000,0.000277777777778,541,1694,1153,1194.000000000000000,453.254343608530689,4776.000000000000000,4,541,1,25.0000000,541,1,25.0000000,1012,1694
3929,4.000000000000000,0.000277777777778,1245,4206,2961,2308.250000000000000,1130.818149615578022,9233.000000000000000,4,1245,1,25.0000000,1245,1,25.0000000,1759,4206
3930,4.000000000000000,0.000277777777778,835,1684,849,1326.250000000000000,366.493775526952163,5305.000000000000000,4,835,1,25.0000000,835,1,25.0000000,1111,1684
3931,4.000000000000000,0.000277777777778,0,20,20,8.500000000000000,7.762087348130012,34.000000000000000,4,0,1,25.0000000,0,1,25.0000000,3,20
3932,5.000000000000000,0.000347222222222,88,649,561,253.000000000000000,201.830622057209155,1265.000000000000000,5,88,1,20.0000000,88,1,20.0000000,191,649
3933,4.000000000000000,0.000277777777778,1071,4591,3520,2364.000000000000000,1334.604623100040044,9456.000000000000000,4,1071,1,25.0000000,1071,1,25.0000000,1728,4591
3934,5.000000000000000,0.000347222222222,203,1374,1171,824.200000000000045,380.544031617893097,4121.000000000000000,5,203,1,20.0000000,203,1,20.0000000,788,1374
3935,4.000000000000000,0.000277777777778,232,820,588,578.750000000000000,214.794523905987887,2315.000000000000000,4,232,1,25.0000000,232,1,25.0000000,615,820
3936,3.000000000000000,0.000208333333333,698,985,287,832.666666666666629,117.831329544490075,2498.000000000000000,3,698,1,33.3333015,698,1,33.3333015,815,985
3937,4.000000000000000,0.000277777777778,936,1969,1033,1417.000000000000000,483.612965086752013,5668.000000000000000,3,936,2,50.0000000,1827,1,25.0000000,936,1969
3938,4.000000000000000,0.000277777777778,512,3720,3208,1494.500000000000000,1301.573951030059561,5978.000000000000000,4,512,1,25.0000000,512,1,25.0000000,666,3720
3939,4.000000000000000,0.000277777777778,697,3590,2893,1692.000000000000000,1164.106739092253520,6768.000000000000000,4,697,1,25.0000000,697,1,25.0000000,782,3590
3940,4.000000000000000,0.000277777777778,548,1805,1257,1219.500000000000000,468.246996786952195,4878.000000000000000,4,548,1,25.0000000,548,1,25.0000000,1063,1805
3941,4.000000000000000,0.000277777777778,1052,2509,1457,1642.750000000000000,597.420862960107911,6571.000000000000000,4,1052,1,25.0000000,1052,1,25.0000000,1124,2509
3942,4.000000000000000,0.000277777777778,1052,2509,1457,1642.750000000000000,597.420862960107911,6571.000000000000000,4,1052,1,25.0000000,1052,1,25.0000000,1124,2509
3943,4.000000000000000,0.000277777777778,726,955,229,867.000000000000000,95.013156983651484,3468.000000000000000,4,726,1,25.0000000,726,1,25.0000000,834,955
3944,4.000000000000000,0.000277777777778,424,1442,1018,1140.250000000000000,417.819563328477898,4561.000000000000000,4,424,1,25.0000000,424,1,25.0000000,1283,1442
3945,4.000000000000000,0.000277777777778,196,587,391,462.500000000000000,158.022941372447576,1850.000000000000000,4,196,1,25.0000000,196,1,25.0000000,493,587
3946,4.000000000000000,0.000277777777778,403,923,520,662.000000000000000,183.862720528115773,2648.000000000000000,4,403,1,25.0000000,403,1,25.0000000,658,923
3947,5.000000000000000,0.000347222222222,215,935,720,554.200000000000045,275.737121186103593,2771.000000000000000,5,215,1,20.0000000,215,1,20.0000000,426,935
3948,4.000000000000000,0.000277777777778,615,1614,999,1127.000000000000000,399.198572141734985,4508.000000000000000,4,615,1,25.0000000,615,1,25.0000000,877,1614
3949,4.000000000000000,0.000277777777778,252,1577,1325,937.750000000000000,469.395022875189852,3751.000000000000000,4,252,1,25.0000000,252,1,25.0000000,935,1577
3950,5.000000000000000,0.000347222222222,275,1622,1347,880.599999999999909,454.291360252426557,4403.000000000000000,5,275,1,20.0000000,275,1,20.0000000,724,1622
3951,3.000000000000000,0.000208333333333,722,2327,1605,1279.666666666666742,741.096634874442202,3839.000000000000000,3,722,1,33.3333015,722,1,33.3333015,790,2327
3952,5.000000000000000,0.000347222222222,661,1911,1250,1291.799999999999955,459.794475825884660,6459.000000000000000,5,661,1,20.0000000,661,1,20.0000000,1405,1911
3953,4.000000000000000,0.000277777777778,310,759,449,537.250000000000000,163.805334162230508,2149.000000000000000,4,310,1,25.0000000,310,1,25.0000000,483,759
3954,4.000000000000000,0.000277777777778,345,886,541,672.500000000000000,204.419299480259440,2690.000000000000000,4,345,1,25.0000000,345,1,25.0000000,667,886
3955,4.000000000000000,0.000277777777778,53,1160,1107,700.000000000000000,408.141519573787036,2800.000000000000000,4,53,1,25.0000000,53,1,25.0000000,697,1160
3956,4.000000000000000,0.000277777777778,666,1331,665,948.000000000000000,244.894875405754476,3792.000000000000000,4,666,1,25.0000000,666,1,25.0000000,832,1331
3957,3.000000000000000,0.000208333333333,440,676,236,547.666666666666629,97.448561929985502,1643.000000000000000,3,440,1,33.3333015,440,1,33.3333015,527,676
3958,4.000000000000000,0.000277777777778,440,676,236,523.750000000000000,94.011634918237633,2095.000000000000000,4,440,1,25.0000000,440,1,25.0000000,452,676
3959,5.000000000000000,0.000347222222222,257,2408,2151,1037.599999999999909,728.305045980048135,5188.000000000000000,5,257,1,20.0000000,257,1,20.0000000,783,2408
3960,4.000000000000000,0.000277777777778,890,2896,2006,1518.250000000000000,802.477530838091411,6073.000000000000000,4,890,1,25.0000000,890,1,25.0000000,1111,2896
3961,4.000000000000000,0.000277777777778,633,1048,415,826.250000000000000,148.834429820522388,3305.000000000000000,4,633,1,25.0000000,633,1,25.0000000,783,1048
3962,4.000000000000000,0.000277777777778,93,366,273,236.250000000000000,97.998405599274932,945.000000000000000,4,93,1,25.0000000,93,1,25.0000000,221,366
3963,4.000000000000000,0.000277777777778,665,1614,949,1096.750000000000000,360.648287809605506,4387.000000000000000,4,665,1,25.0000000,665,1,25.0000000,877,1614
3964,4.000000000000000,0.000277777777778,967,1488,521,1192.500000000000000,190.736074196781146,4770.000000000000000,4,967,1,25.0000000,967,1,25.0000000,1108,1488
3965,4.000000000000000,0.000277777777778,325,1026,701,579.000000000000000,266.068600176721361,2316.000000000000000,4,325,1,25.0000000,325,1,25.0000000,472,1026
3966,4.000000000000000,0.000277777777778,279,900,621,606.250000000000000,246.916357295339992,2425.000000000000000,4,279,1,25.0000000,279,1,25.0000000,465,900
3967,4.000000000000000,0.000277777777778,703,1035,332,836.750000000000000,121.734085202132277,3347.000000000000000,4,703,1,25.0000000,703,1,25.0000000,803,1035
3968,4.000000000000000,0.000277777777778,238,332,94,300.500000000000000,36.670833096617812,1202.000000000000000,3,316,2,50.0000000,238,1,25.0000000,316,332
3969,4.000000000000000,0.000277777777778,831,1921,1090,1168.000000000000000,439.773805495506963,4672.000000000000000,4,831,1,25.0000000,831,1,25.0000000,903,1921
3970,3.000000000000000,0.000208333333333,431,591,160,493.000000000000000,70.104683628604064,1479.000000000000000,3,431,1,33.3333015,431,1,33.3333015,457,591
3971,5.000000000000000,0.000347222222222,127,2443,2316,824.399999999999977,867.437052471244215,4122.000000000000000,5,127,1,20.0000000,127,1,20.0000000,297,2443
3972,4.000000000000000,0.000277777777778,235,576,341,329.000000000000000,143.260252687198630,1316.000000000000000,4,235,1,25.0000000,235,1,25.0000000,236,576
3973,4.000000000000000,0.000277777777778,227,717,490,447.250000000000000,205.927626849823127,1789.000000000000000,4,227,1,25.0000000,227,1,25.0000000,269,717
3974,4.000000000000000,0.000277777777778,704,2373,1669,1692.500000000000000,614.136996117315789,6770.000000000000000,4,704,1,25.0000000,704,1,25.0000000,1744,2373
3975,4.000000000000000,0.000277777777778,666,1597,931,1120.000000000000000,439.013097754497551,4480.000000000000000,4,666,1,25.0000000,666,1,25.0000000,698,1597
3976,4.000000000000000,0.000277777777778,1384,8475,7091,3587.000000000000000,2844.111372643483719,14348.000000000000000,4,1384,1,25.0000000,1384,1,25.0000000,2192,8475
3977,4.000000000000000,0.000277777777778,1384,8475,7091,3587.000000000000000,2844.111372643483719,14348.000000000000000,4,1384,1,25.0000000,1384,1,25.0000000,2192,8475
3978,4.000000000000000,0.000277777777778,785,1128,343,924.750000000000000,141.558071122772787,3699.000000000000000,4,785,1,25.0000000,785,1,25.0000000,800,1128
3979,4.000000000000000,0.000277777777778,1260,2651,1391,1941.500000000000000,548.682285115894842,7766.000000000000000,4,1260,1,25.0000000,1260,1,25.0000000,1584,2651
3980,5.000000000000000,0.000347222222222,439,1211,772,752.399999999999977,302.826418926750819,3762.000000000000000,5,439,1,20.0000000,439,1,20.0000000,659,1211
3981,4.000000000000000,0.000277777777778,502,1718,1216,931.500000000000000,477.435074120031516,3726.000000000000000,4,502,1,25.0000000,502,1,25.0000000,603,1718
3982,4.000000000000000,0.000277777777778,442,2018,1576,1183.500000000000000,585.991680828320341,4734.000000000000000,4,442,1,25.0000000,442,1,25.0000000,889,2018
3983,4.000000000000000,0.000277777777778,1497,4086,2589,2297.500000000000000,1048.650203833480191,9190.000000000000000,4,1497,1,25.0000000,1497,1,25.0000000,1615,4086
3984,3.000000000000000,0.000208333333333,232,820,588,528.333333333333371,240.072674181983672,1585.000000000000000,3,232,1,33.3333015,232,1,33.3333015,533,820
3985,4.000000000000000,0.000277777777778,171,1900,1729,825.500000000000000,699.579337888133978,3302.000000000000000,4,171,1,25.0000000,171,1,25.0000000,237,1900
3986,5.000000000000000,0.000347222222222,913,1123,210,1003.200000000000045,80.040989499131015,5016.000000000000000,5,913,1,20.0000000,913,1,20.0000000,1003,1123
3987,4.000000000000000,0.000277777777778,718,829,111,772.250000000000000,43.060277518845616,3089.000000000000000,4,718,1,25.0000000,718,1,25.0000000,746,829
3988,4.000000000000000,0.000277777777778,616,2456,1840,1346.250000000000000,677.989813714040906,5385.000000000000000,4,616,1,25.0000000,616,1,25.0000000,1126,2456
3989,4.000000000000000,0.000277777777778,253,2549,2296,1107.500000000000000,900.543585841351614,4430.000000000000000,4,253,1,25.0000000,253,1,25.0000000,451,2549
3990,4.000000000000000,0.000277777777778,553,851,298,736.750000000000000,113.018527242218141,2947.000000000000000,4,553,1,25.0000000,553,1,25.0000000,741,851
3991,3.000000000000000,0.000208333333333,959,1609,650,1195.333333333333258,293.496545503047116,3586.000000000000000,3,959,1,33.3333015,959,1,33.3333015,1018,1609
3992,4.000000000000000,0.000277777777778,355,702,347,510.250000000000000,156.946447873151953,2041.000000000000000,4,355,1,25.0000000,355,1,25.0000000,356,702
3993,4.000000000000000,0.000277777777778,179,1001,822,556.500000000000000,308.840978498644176,2226.000000000000000,4,179,1,25.0000000,179,1,25.0000000,383,1001
3994,5.000000000000000,0.000347222222222,273,7668,7395,2063.199999999999818,2813.246978137539827,10316.000000000000000,5,273,1,20.0000000,273,1,20.0000000,901,7668
3995,3.000000000000000,0.000208333333333,1193,1255,62,1221.000000000000000,25.664502073226878,3663.000000000000000,3,1193,1,33.3333015,1193,1,33.3333015,1215,1255
3996,3.000000000000000,0.000208333333333,1343,3449,2106,2212.666666666666515,898.013486659427713,6638.000000000000000,3,1343,1,33.3333015,1343,1,33.3333015,1846,3449
3997,4.000000000000000,0.000277777777778,692,1601,909,1001.500000000000000,355.792425439328326,4006.000000000000000,4,692,1,25.0000000,692,1,25.0000000,789,1601
3998,4.000000000000000,0.000277777777778,343,1250,907,870.500000000000000,353.497171134367022,3482.000000000000000,4,343,1,25.0000000,343,1,25.0000000,762,1250
3999,4.000000000000000,0.000277777777778,580,2088,1508,1066.750000000000000,610.042365332113604,4267.000000000000000,4,580,1,25.0000000,580,1,25.0000000,618,2088
4000,5.000000000000000,0.000347222222222,1070,1688,618,1349.000000000000000,239.567944433306849,6745.000000000000000,5,1070,1,20.0000000,1070,1,20.0000000,1364,1688
4001,3.000000000000000,0.000208333333333,800,1643,843,1244.000000000000000,345.621179906556051,3732.000000000000000,3,800,1,33.3333015,800,1,33.3333015,1289,1643
4002,4.000000000000000,0.000277777777778,163,661,498,455.750000000000000,191.009652897438656,1823.000000000000000,4,163,1,25.0000000,163,1,25.0000000,415,661
4003,3.000000000000000,0.000208333333333,425,1010,585,809.000000000000000,271.628422665964763,2427.000000000000000,3,425,1,33.3333015,425,1,33.3333015,992,1010
4004,5.000000000000000,0.000347222222222,425,1515,1090,908.600000000000023,413.633944448470004,4543.000000000000000,5,425,1,20.0000000,425,1,20.0000000,1010,1515
4005,3.000000000000000,0.000208333333333,425,1127,702,854.000000000000000,307.086307086460636,2562.000000000000000,3,425,1,33.3333015,425,1,33.3333015,1010,1127
4006,4.000000000000000,0.000277777777778,352,809,457,577.500000000000000,161.648538502517852,2310.000000000000000,4,352,1,25.0000000,352,1,25.0000000,569,809
4007,4.000000000000000,0.000277777777778,458,1426,968,901.500000000000000,345.465265981979712,3606.000000000000000,4,458,1,25.0000000,458,1,25.0000000,827,1426
4008,3.000000000000000,0.000208333333333,624,1290,666,997.666666666666629,277.909257772308763,2993.000000000000000,3,624,1,33.3333015,624,1,33.3333015,1079,1290
4009,4.000000000000000,0.000277777777778,624,1717,1093,1177.500000000000000,393.630854989798763,4710.000000000000000,4,624,1,25.0000000,624,1,25.0000000,1079,1717
4010,4.000000000000000,0.000277777777778,1056,1998,942,1472.750000000000000,374.125229702568959,5891.000000000000000,4,1056,1,25.0000000,1056,1,25.0000000,1190,1998
4011,4.000000000000000,0.000277777777778,1056,1998,942,1472.750000000000000,374.125229702568959,5891.000000000000000,4,1056,1,25.0000000,1056,1,25.0000000,1190,1998
4012,4.000000000000000,0.000277777777778,647,3948,3301,1996.000000000000000,1374.295637772309874,7984.000000000000000,4,647,1,25.0000000,647,1,25.0000000,761,3948
4013,4.000000000000000,0.000277777777778,757,1603,846,1272.500000000000000,323.470632360961019,5090.000000000000000,4,757,1,25.0000000,757,1,25.0000000,1250,1603
4014,4.000000000000000,0.000277777777778,518,1089,571,862.500000000000000,213.333658853918308,3450.000000000000000,4,518,1,25.0000000,518,1,25.0000000,871,1089
4015,4.000000000000000,0.000277777777778,1045,2185,1140,1379.250000000000000,467.205722888750586,5517.000000000000000,4,1045,1,25.0000000,1045,1,25.0000000,1121,2185
4016,4.000000000000000,0.000277777777778,1045,2185,1140,1379.250000000000000,467.205722888750586,5517.000000000000000,4,1045,1,25.0000000,1045,1,25.0000000,1121,2185
4017,4.000000000000000,0.000277777777778,329,995,666,656.750000000000000,270.625548498289447,2627.000000000000000,4,329,1,25.0000000,329,1,25.0000000,463,995
4018,4.000000000000000,0.000277777777778,1263,5234,3971,3063.000000000000000,1428.182936461572581,12252.000000000000000,4,1263,1,25.0000000,1263,1,25.0000000,2616,5234
4019,5.000000000000000,0.000347222222222,236,1207,971,771.799999999999955,355.165538868849183,3859.000000000000000,5,236,1,20.0000000,236,1,20.0000000,736,1207
4020,4.000000000000000,0.000277777777778,171,1128,957,662.000000000000000,458.628934979030703,2648.000000000000000,4,171,1,25.0000000,171,1,25.0000000,237,1128
4021,4.000000000000000,0.000277777777778,676,2601,1925,1417.250000000000000,715.684768246467570,5669.000000000000000,4,676,1,25.0000000,676,1,25.0000000,1186,2601
4022,4.000000000000000,0.000277777777778,809,1597,788,1217.500000000000000,280.011160491863222,4870.000000000000000,4,809,1,25.0000000,809,1,25.0000000,1198,1597
4023,4.000000000000000,0.000277777777778,734,1511,777,1095.000000000000000,315.003968228973292,4380.000000000000000,4,734,1,25.0000000,734,1,25.0000000,853,1511
4024,4.000000000000000,0.000277777777778,886,1927,1041,1257.500000000000000,409.305814764461843,5030.000000000000000,4,886,1,25.0000000,886,1,25.0000000,968,1927
4025,4.000000000000000,0.000277777777778,968,1927,959,1292.000000000000000,381.403329822905448,5168.000000000000000,4,968,1,25.0000000,968,1,25.0000000,1024,1927
4026,4.000000000000000,0.000277777777778,272,611,339,464.750000000000000,124.298783179884751,1859.000000000000000,4,272,1,25.0000000,272,1,25.0000000,455,611
4027,5.000000000000000,0.000347222222222,272,611,339,428.000000000000000,133.275654190853629,2140.000000000000000,5,272,1,20.0000000,272,1,20.0000000,455,611
4028,4.000000000000000,0.000277777777778,801,1337,536,1006.500000000000000,207.602384379370733,4026.000000000000000,4,801,1,25.0000000,801,1,25.0000000,863,1337
4029,4.000000000000000,0.000277777777778,73,494,421,278.750000000000000,192.275030880247158,1115.000000000000000,4,73,1,25.0000000,73,1,25.0000000,102,494
4030,4.000000000000000,0.000277777777778,789,1762,973,1073.250000000000000,400.812534110399270,4293.000000000000000,4,789,1,25.0000000,789,1,25.0000000,818,1762
4031,3.000000000000000,0.000208333333333,789,1201,412,971.333333333333371,171.496031700120938,2914.000000000000000,3,789,1,33.3333015,789,1,33.3333015,924,1201
4032,5.000000000000000,0.000347222222222,261,1129,868,600.600000000000023,363.076080181550935,3003.000000000000000,5,261,1,20.0000000,261,1,20.0000000,341,1129
4033,4.000000000000000,0.000277777777778,438,1360,922,945.000000000000000,376.033243211288436,3780.000000000000000,4,438,1,25.0000000,438,1,25.0000000,734,1360
4034,5.000000000000000,0.000347222222222,1446,2864,1418,2193.599999999999909,633.772388164710151,10968.000000000000000,5,1446,1,20.0000000,1446,1,20.0000000,2341,2864
4035,4.000000000000000,0.000277777777778,1460,2864,1404,2380.500000000000000,572.211717810811706,9522.000000000000000,4,1460,1,25.0000000,1460,1,25.0000000,2341,2864
4036,4.000000000000000,0.000277777777778,1158,2864,1706,1955.750000000000000,681.085301192148791,7823.000000000000000,4,1158,1,25.0000000,1158,1,25.0000000,1460,2864
4037,4.000000000000000,0.000277777777778,1202,1543,341,1384.250000000000000,152.491598129208427,5537.000000000000000,4,1202,1,25.0000000,1202,1,25.0000000,1265,1543
4038,4.000000000000000,0.000277777777778,2030,8104,6074,4043.999999999999545,2378.741999461060004,16176.000000000000000,4,2030,1,25.0000000,2030,1,25.0000000,3001,8104
4039,4.000000000000000,0.000277777777778,257,1005,748,576.000000000000000,314.934120094981154,2304.000000000000000,4,257,1,25.0000000,257,1,25.0000000,292,1005
4040,4.000000000000000,0.000277777777778,150,1758,1608,957.250000000000000,576.896600353997542,3829.000000000000000,4,150,1,25.0000000,150,1,25.0000000,822,1758
4041,4.000000000000000,0.000277777777778,92,657,565,359.250000000000000,217.020016357938744,1437.000000000000000,4,92,1,25.0000000,92,1,25.0000000,226,657
4042,4.000000000000000,0.000277777777778,953,1326,373,1154.250000000000000,170.765006661200914,4617.000000000000000,4,953,1,25.0000000,953,1,25.0000000,1017,1326
4043,5.000000000000000,0.000347222222222,696,2018,1322,1167.599999999999909,485.126210382411728,5838.000000000000000,5,696,1,20.0000000,696,1,20.0000000,889,2018
4044,4.000000000000000,0.000277777777778,685,1542,857,1272.500000000000000,350.987535391215829,5090.000000000000000,3,1542,2,50.0000000,685,1,25.0000000,1321,1542
4045,5.000000000000000,0.000347222222222,444,1436,992,805.200000000000045,332.720543399412009,4026.000000000000000,4,703,2,40.0000000,444,1,20.0000000,703,1436
4046,4.000000000000000,0.000277777777778,2261,5234,2973,3606.750000000000000,1085.410607788591506,14427.000000000000000,4,2261,1,25.0000000,2261,1,25.0000000,3139,5234
4047,4.000000000000000,0.000277777777778,1860,4244,2384,2876.000000000000000,915.296946351292036,11504.000000000000000,4,1860,1,25.0000000,1860,1,25.0000000,2261,4244
4048,4.000000000000000,0.000277777777778,919,1634,715,1282.500000000000000,260.321435921055127,5130.000000000000000,4,919,1,25.0000000,919,1,25.0000000,1201,1634
4049,4.000000000000000,0.000277777777778,332,2359,2027,1514.250000000000000,795.223356988462683,6057.000000000000000,4,332,1,25.0000000,332,1,25.0000000,1258,2359
4050,4.000000000000000,0.000277777777778,881,1322,441,1052.500000000000000,171.715607910288696,4210.000000000000000,4,881,1,25.0000000,881,1,25.0000000,929,1322
4051,4.000000000000000,0.000277777777778,388,1000,612,708.000000000000000,216.828273064192445,2832.000000000000000,4,388,1,25.0000000,388,1,25.0000000,721,1000
4052,4.000000000000000,0.000277777777778,536,3659,3123,1634.000000000000000,1210.309671117272273,6536.000000000000000,4,536,1,25.0000000,536,1,25.0000000,922,3659
4053,4.000000000000000,0.000277777777778,671,2119,1448,1326.000000000000000,631.215890167540010,5304.000000000000000,4,671,1,25.0000000,671,1,25.0000000,744,2119
4054,4.000000000000000,0.000277777777778,671,2119,1448,1326.000000000000000,631.215890167540010,5304.000000000000000,4,671,1,25.0000000,671,1,25.0000000,744,2119
4055,4.000000000000000,0.000277777777778,509,1078,569,850.000000000000000,209.022726037146498,3400.000000000000000,4,509,1,25.0000000,509,1,25.0000000,899,1078
4056,4.000000000000000,0.000277777777778,653,976,323,839.750000000000000,122.183008229458807,3359.000000000000000,4,653,1,25.0000000,653,1,25.0000000,815,976
4057,4.000000000000000,0.000277777777778,555,1034,479,737.250000000000000,191.221566513821870,2949.000000000000000,4,555,1,25.0000000,555,1,25.0000000,584,1034
4058,3.000000000000000,0.000208333333333,498,3311,2813,1476.333333333333258,1298.260973593351082,4429.000000000000000,3,498,1,33.3333015,498,1,33.3333015,620,3311
4059,4.000000000000000,0.000277777777778,702,1436,734,1052.250000000000000,269.583359093249669,4209.000000000000000,4,702,1,25.0000000,702,1,25.0000000,935,1436
4060,4.000000000000000,0.000277777777778,985,2609,1624,1837.750000000000000,747.083454173628411,7351.000000000000000,4,985,1,25.0000000,985,1,25.0000000,1205,2609
4061,4.000000000000000,0.000277777777778,1497,4086,2589,2297.500000000000000,1048.650203833480191,9190.000000000000000,4,1497,1,25.0000000,1497,1,25.0000000,1615,4086
4062,5.000000000000000,0.000347222222222,369,1639,1270,677.799999999999955,483.161008360567109,3389.000000000000000,5,369,1,20.0000000,369,1,20.0000000,430,1639
4063,4.000000000000000,0.000277777777778,52,1724,1672,631.000000000000000,652.583328012599509,2524.000000000000000,4,52,1,25.0000000,52,1,25.0000000,230,1724
4064,4.000000000000000,0.000277777777778,940,2336,1396,1700.750000000000000,502.990742956567715,6803.000000000000000,4,940,1,25.0000000,940,1,25.0000000,1659,2336
4065,5.000000000000000,0.000347222222222,511,1052,541,812.200000000000045,205.178361432193896,4061.000000000000000,5,511,1,20.0000000,511,1,20.0000000,932,1052
4066,4.000000000000000,0.000277777777778,240,803,563,589.250000000000000,224.190070029874420,2357.000000000000000,4,240,1,25.0000000,240,1,25.0000000,547,803
4067,3.000000000000000,0.000208333333333,171,1112,941,506.666666666666686,428.882527298819014,1520.000000000000000,3,171,1,33.3333015,171,1,33.3333015,237,1112
4068,4.000000000000000,0.000277777777778,171,1900,1729,872.250000000000000,693.927364714780424,3489.000000000000000,4,171,1,25.0000000,171,1,25.0000000,306,1900
4069,4.000000000000000,0.000277777777778,784,2018,1234,1223.250000000000000,480.056962765878438,4893.000000000000000,4,784,1,25.0000000,784,1,25.0000000,915,2018
4070,4.000000000000000,0.000277777777778,1028,2601,1573,1769.750000000000000,558.116195339285923,7079.000000000000000,4,1028,1,25.0000000,1028,1,25.0000000,1705,2601
4071,4.000000000000000,0.000277777777778,821,2606,1785,1393.500000000000000,727.900577002106843,5574.000000000000000,4,821,1,25.0000000,821,1,25.0000000,832,2606
4072,4.000000000000000,0.000277777777778,68,671,603,282.750000000000000,233.917052606260398,1131.000000000000000,4,68,1,25.0000000,68,1,25.0000000,137,671
4073,4.000000000000000,0.000277777777778,1323,2515,1192,1938.250000000000000,506.150854489054495,7753.000000000000000,4,1323,1,25.0000000,1323,1,25.0000000,1562,2515
4074,3.000000000000000,0.000208333333333,1562,4874,3312,2983.666666666666515,1392.138004014767830,8951.000000000000000,3,1562,1,33.3333015,1562,1,33.3333015,2515,4874
4075,4.000000000000000,0.000277777777778,1033,1313,280,1159.750000000000000,110.696375279410120,4639.000000000000000,4,1033,1,25.0000000,1033,1,25.0000000,1079,1313
4076,4.000000000000000,0.000277777777778,820,2182,1362,1565.000000000000000,608.816064177022213,6260.000000000000000,4,820,1,25.0000000,820,1,25.0000000,1110,2182
4077,4.000000000000000,0.000277777777778,884,2962,2078,1776.500000000000000,840.205183273704847,7106.000000000000000,4,884,1,25.0000000,884,1,25.0000000,1092,2962
4078,4.000000000000000,0.000277777777778,752,1939,1187,1085.750000000000000,493.581996734078587,4343.000000000000000,4,752,1,25.0000000,752,1,25.0000000,818,1939
4079,5.000000000000000,0.000347222222222,715,1513,798,1118.000000000000000,260.156875749998221,5590.000000000000000,4,1063,2,40.0000000,715,1,20.0000000,1063,1513
4080,4.000000000000000,0.000277777777778,352,3566,3214,1367.750000000000000,1291.899449454174828,5471.000000000000000,4,352,1,25.0000000,352,1,25.0000000,539,3566
4081,4.000000000000000,0.000277777777778,750,1902,1152,1216.750000000000000,424.000810730356989,4867.000000000000000,4,750,1,25.0000000,750,1,25.0000000,1045,1902
4082,4.000000000000000,0.000277777777778,750,1902,1152,1312.250000000000000,445.205781072079048,5249.000000000000000,4,750,1,25.0000000,750,1,25.0000000,1045,1902
4083,4.000000000000000,0.000277777777778,747,1728,981,1137.000000000000000,361.926097428743049,4548.000000000000000,4,747,1,25.0000000,747,1,25.0000000,1002,1728
4084,4.000000000000000,0.000277777777778,747,1728,981,1188.000000000000000,363.402669225199816,4752.000000000000000,4,747,1,25.0000000,747,1,25.0000000,1002,1728
4085,4.000000000000000,0.000277777777778,724,1622,898,1207.250000000000000,333.806362282087093,4829.000000000000000,4,724,1,25.0000000,724,1,25.0000000,1104,1622
4086,4.000000000000000,0.000277777777778,833,2857,2024,1889.250000000000000,740.419602320197896,7557.000000000000000,4,833,1,25.0000000,833,1,25.0000000,1672,2857
4087,4.000000000000000,0.000277777777778,351,1542,1191,1029.000000000000000,478.191907083338265,4116.000000000000000,4,351,1,25.0000000,351,1,25.0000000,813,1542
4088,4.000000000000000,0.000277777777778,351,1542,1191,1029.000000000000000,478.191907083338265,4116.000000000000000,4,351,1,25.0000000,351,1,25.0000000,813,1542
4089,4.000000000000000,0.000277777777778,342,1606,1264,1024.750000000000000,523.734367308466744,4099.000000000000000,4,342,1,25.0000000,342,1,25.0000000,696,1606
4090,4.000000000000000,0.000277777777778,168,1758,1590,878.250000000000000,575.829998784363397,3513.000000000000000,4,168,1,25.0000000,168,1,25.0000000,664,1758
4091,5.000000000000000,0.000347222222222,168,1758,1590,819.799999999999955,528.138012265733437,4099.000000000000000,5,168,1,20.0000000,168,1,20.0000000,664,1758
4092,5.000000000000000,0.000347222222222,168,1758,1590,819.799999999999955,528.138012265733437,4099.000000000000000,5,168,1,20.0000000,168,1,20.0000000,664,1758
4093,4.000000000000000,0.000277777777778,1242,2515,1273,2042.000000000000000,490.078055007567116,8168.000000000000000,4,1242,1,25.0000000,1242,1,25.0000000,2058,2515
4094,4.000000000000000,0.000277777777778,688,3054,2366,1517.750000000000000,911.959531722762449,6071.000000000000000,4,688,1,25.0000000,688,1,25.0000000,1045,3054
4095,4.000000000000000,0.000277777777778,1282,2560,1278,1943.750000000000000,532.244480948370210,7775.000000000000000,4,1282,1,25.0000000,1282,1,25.0000000,1570,2560
4096,5.000000000000000,0.000347222222222,72,1429,1357,741.200000000000045,445.557358821510206,3706.000000000000000,5,72,1,20.0000000,72,1,20.0000000,778,1429
4097,4.000000000000000,0.000277777777778,545,1063,518,757.250000000000000,198.663503190696815,3029.000000000000000,4,545,1,25.0000000,545,1,25.0000000,624,1063
4098,4.000000000000000,0.000277777777778,507,2297,1790,1419.250000000000000,634.183086734422432,5677.000000000000000,4,507,1,25.0000000,507,1,25.0000000,1384,2297
4099,3.000000000000000,0.000208333333333,1384,2297,913,1957.666666666666742,407.902221398979634,5873.000000000000000,3,1384,1,33.3333015,1384,1,33.3333015,2192,2297
4100,4.000000000000000,0.000277777777778,507,2297,1790,1595.000000000000000,720.672949402154245,6380.000000000000000,4,507,1,25.0000000,507,1,25.0000000,1384,2297
4101,5.000000000000000,0.000347222222222,726,1707,981,1215.599999999999909,387.329627062015504,6078.000000000000000,5,726,1,20.0000000,726,1,20.0000000,1020,1707
4102,5.000000000000000,0.000347222222222,168,1758,1590,919.200000000000045,525.035008356585649,4596.000000000000000,5,168,1,20.0000000,168,1,20.0000000,878,1758
4103,4.000000000000000,0.000277777777778,486,868,382,587.250000000000000,162.159450850081498,2349.000000000000000,4,486,1,25.0000000,486,1,25.0000000,497,868
4104,4.000000000000000,0.000277777777778,81,1082,1001,656.250000000000000,362.218425124951352,2625.000000000000000,4,81,1,25.0000000,81,1,25.0000000,704,1082
4105,4.000000000000000,0.000277777777778,236,614,378,395.500000000000000,136.926074945570548,1582.000000000000000,4,236,1,25.0000000,236,1,25.0000000,360,614
4106,3.000000000000000,0.000208333333333,2261,4206,1945,3420.000000000000000,836.701061710015210,10260.000000000000000,3,2261,1,33.3333015,2261,1,33.3333015,3793,4206
4107,4.000000000000000,0.000277777777778,72,1037,965,695.000000000000000,370.255992524091369,2780.000000000000000,4,72,1,25.0000000,72,1,25.0000000,792,1037
4108,4.000000000000000,0.000277777777778,179,1312,1133,624.250000000000000,442.916682345562606,2497.000000000000000,4,179,1,25.0000000,179,1,25.0000000,298,1312
4109,4.000000000000000,0.000277777777778,610,3082,2472,2013.750000000000000,951.085268259371105,8055.000000000000000,4,610,1,25.0000000,610,1,25.0000000,1707,3082
4110,4.000000000000000,0.000277777777778,610,3082,2472,2013.750000000000000,951.085268259371105,8055.000000000000000,4,610,1,25.0000000,610,1,25.0000000,1707,3082
4111,4.000000000000000,0.000277777777778,585,2890,2305,1455.750000000000000,865.835831725622256,5823.000000000000000,4,585,1,25.0000000,585,1,25.0000000,1063,2890
4112,4.000000000000000,0.000277777777778,527,2932,2405,1136.500000000000000,1036.661588947907376,4546.000000000000000,4,527,1,25.0000000,527,1,25.0000000,538,2932
4113,4.000000000000000,0.000277777777778,875,4386,3511,1774.249999999999773,1508.039186327729340,7097.000000000000000,4,875,1,25.0000000,875,1,25.0000000,902,4386
4114,5.000000000000000,0.000347222222222,893,2115,1222,1612.000000000000000,470.661236984734046,8060.000000000000000,5,893,1,20.0000000,893,1,20.0000000,1772,2115
4115,4.000000000000000,0.000277777777778,642,2199,1557,1216.750000000000000,619.925146691114605,4867.000000000000000,4,642,1,25.0000000,642,1,25.0000000,731,2199
4116,4.000000000000000,0.000277777777778,731,2199,1468,1304.250000000000000,553.800223456076196,5217.000000000000000,4,731,1,25.0000000,731,1,25.0000000,992,2199
4117,4.000000000000000,0.000277777777778,1124,2374,1250,1770.250000000000000,442.848944336553643,7081.000000000000000,4,1124,1,25.0000000,1124,1,25.0000000,1765,2374
4118,4.000000000000000,0.000277777777778,175,1084,909,591.750000000000000,333.650546979920307,2367.000000000000000,4,175,1,25.0000000,175,1,25.0000000,439,1084
4119,4.000000000000000,0.000277777777778,828,1089,261,940.000000000000000,100.660319888226070,3760.000000000000000,4,828,1,25.0000000,828,1,25.0000000,871,1089
4120,4.000000000000000,0.000277777777778,247,2107,1860,1394.750000000000000,694.176625578821927,5579.000000000000000,4,247,1,25.0000000,247,1,25.0000000,1549,2107
4121,3.000000000000000,0.000208333333333,548,1016,468,831.000000000000000,203.238775827842460,2493.000000000000000,3,548,1,33.3333015,548,1,33.3333015,929,1016
4122,4.000000000000000,0.000277777777778,273,1484,1211,734.250000000000000,454.131795297356405,2937.000000000000000,4,273,1,25.0000000,273,1,25.0000000,525,1484
4123,4.000000000000000,0.000277777777778,1006,1609,603,1310.500000000000000,298.530149231195765,5242.000000000000000,3,1609,2,50.0000000,1006,1,25.0000000,1018,1609
4124,3.000000000000000,0.000208333333333,498,3311,2813,1476.333333333333258,1298.260973593351082,4429.000000000000000,3,498,1,33.3333015,498,1,33.3333015,620,3311
4125,5.000000000000000,0.000347222222222,671,2194,1523,1463.599999999999909,578.528685546360748,7318.000000000000000,5,671,1,20.0000000,671,1,20.0000000,1770,2194
4126,5.000000000000000,0.000347222222222,463,995,532,835.399999999999977,193.695224515216154,4177.000000000000000,5,463,1,20.0000000,463,1,20.0000000,910,995
4127,4.000000000000000,0.000277777777778,217,634,417,387.000000000000000,153.995129793120412,1548.000000000000000,4,217,1,25.0000000,217,1,25.0000000,317,634
4128,4.000000000000000,0.000277777777778,537,1454,917,983.000000000000000,347.120296151060586,3932.000000000000000,4,537,1,25.0000000,537,1,25.0000000,796,1454
4129,5.000000000000000,0.000347222222222,299,1476,1177,998.200000000000045,417.688592135337103,4991.000000000000000,5,299,1,20.0000000,299,1,20.0000000,971,1476
4130,4.000000000000000,0.000277777777778,352,718,366,499.000000000000000,134.851770474102409,1996.000000000000000,4,352,1,25.0000000,352,1,25.0000000,446,718
4131,4.000000000000000,0.000277777777778,562,1528,966,1067.250000000000000,364.788551766636431,4269.000000000000000,4,562,1,25.0000000,562,1,25.0000000,911,1528
4132,4.000000000000000,0.000277777777778,154,704,550,446.500000000000000,221.519186527939382,1786.000000000000000,4,154,1,25.0000000,154,1,25.0000000,316,704
4133,4.000000000000000,0.000277777777778,729,1777,1048,1354.500000000000000,388.957902606438893,5418.000000000000000,4,729,1,25.0000000,729,1,25.0000000,1370,1777
4134,4.000000000000000,0.000277777777778,729,1777,1048,1354.500000000000000,388.957902606438893,5418.000000000000000,4,729,1,25.0000000,729,1,25.0000000,1370,1777
4135,4.000000000000000,0.000277777777778,2728,33553,30825,18234.250000000000000,14316.199187895508658,72937.000000000000000,4,2728,1,25.0000000,2728,1,25.0000000,5200,33553
4136,4.000000000000000,0.000277777777778,1704,2916,1212,2165.000000000000000,454.494224385745099,8660.000000000000000,4,1704,1,25.0000000,1704,1,25.0000000,1958,2916
4137,4.000000000000000,0.000277777777778,244,1005,761,449.500000000000000,321.198147566264765,1798.000000000000000,4,244,1,25.0000000,244,1,25.0000000,257,1005
4138,4.000000000000000,0.000277777777778,358,813,455,585.500000000000000,163.521405326642167,2342.000000000000000,4,358,1,25.0000000,358,1,25.0000000,544,813
4139,4.000000000000000,0.000277777777778,358,847,489,594.000000000000000,175.566226820536286,2376.000000000000000,4,358,1,25.0000000,358,1,25.0000000,544,847
4140,4.000000000000000,0.000277777777778,66,1159,1093,804.250000000000000,432.462353852910553,3217.000000000000000,4,66,1,25.0000000,66,1,25.0000000,953,1159
4141,5.000000000000000,0.000347222222222,262,1365,1103,919.799999999999955,376.383527801098069,4599.000000000000000,5,262,1,20.0000000,262,1,20.0000000,985,1365
4142,4.000000000000000,0.000277777777778,318,1600,1282,960.750000000000114,513.903383429220185,3843.000000000000000,4,318,1,25.0000000,318,1,25.0000000,620,1600
4143,4.000000000000000,0.000277777777778,318,1600,1282,1087.500000000000000,475.303324204659930,4350.000000000000000,4,318,1,25.0000000,318,1,25.0000000,1127,1600
4144,4.000000000000000,0.000277777777778,318,1600,1282,1087.500000000000000,475.303324204659930,4350.000000000000000,4,318,1,25.0000000,318,1,25.0000000,1127,1600
4145,4.000000000000000,0.000277777777778,215,821,606,439.250000000000000,232.918843162162403,1757.000000000000000,4,215,1,25.0000000,215,1,25.0000000,295,821
4146,3.000000000000000,0.000208333333333,486,1008,522,680.333333333333371,233.029802576599394,2041.000000000000000,3,486,1,33.3333015,486,1,33.3333015,547,1008
4147,5.000000000000000,0.000347222222222,194,951,757,498.800000000000011,317.764944573815455,2494.000000000000000,5,194,1,20.0000000,194,1,20.0000000,337,951
4148,4.000000000000000,0.000277777777778,632,1066,434,907.750000000000000,176.071540857686585,3631.000000000000000,4,632,1,25.0000000,632,1,25.0000000,877,1066
4149,4.000000000000000,0.000277777777778,632,1066,434,907.750000000000000,176.071540857686585,3631.000000000000000,4,632,1,25.0000000,632,1,25.0000000,877,1066
4150,4.000000000000000,0.000277777777778,632,1066,434,907.750000000000000,176.071540857686585,3631.000000000000000,4,632,1,25.0000000,632,1,25.0000000,877,1066
4151,4.000000000000000,0.000277777777778,719,2121,1402,1480.750000000000000,603.218192282029918,5923.000000000000000,4,719,1,25.0000000,719,1,25.0000000,1063,2121
4152,3.000000000000000,0.000208333333333,55,1647,1592,929.333333333333371,659.304852772136769,2788.000000000000000,3,55,1,33.3333015,55,1,33.3333015,1086,1647
4153,4.000000000000000,0.000277777777778,537,1326,789,891.750000000000000,283.187548278521604,3567.000000000000000,4,537,1,25.0000000,537,1,25.0000000,812,1326
4154,4.000000000000000,0.000277777777778,537,1326,789,891.750000000000000,283.187548278521604,3567.000000000000000,4,537,1,25.0000000,537,1,25.0000000,812,1326
4155,5.000000000000000,0.000347222222222,703,1902,1199,1260.400000000000091,501.577750702720039,6302.000000000000000,5,703,1,20.0000000,703,1,20.0000000,1170,1902
4156,6.000000000000000,0.000416666666667,259,863,604,464.166666666666686,193.441995325615778,2785.000000000000000,6,259,1,16.6667004,259,1,16.6667004,366,477
4157,4.000000000000000,0.000277777777778,1015,1749,734,1426.250000000000000,284.483193703951486,5705.000000000000000,4,1015,1,25.0000000,1015,1,25.0000000,1318,1749
4158,4.000000000000000,0.000277777777778,1014,2586,1572,1761.500000000000000,672.229313553046381,7046.000000000000000,4,1014,1,25.0000000,1014,1,25.0000000,1191,2586
4159,3.000000000000000,0.000208333333333,1518,2586,1068,2119.666666666666515,446.387226021932122,6359.000000000000000,3,1518,1,33.3333015,1518,1,33.3333015,2255,2586
4160,5.000000000000000,0.000347222222222,586,1036,450,744.200000000000045,153.417600033372963,3721.000000000000000,5,586,1,20.0000000,586,1,20.0000000,694,1036
4161,4.000000000000000,0.000277777777778,270,1066,796,797.500000000000000,316.550548885955948,3190.000000000000000,4,270,1,25.0000000,270,1,25.0000000,835,1066
4162,4.000000000000000,0.000277777777778,270,1066,796,797.500000000000000,316.550548885955948,3190.000000000000000,4,270,1,25.0000000,270,1,25.0000000,835,1066
4163,4.000000000000000,0.000277777777778,718,933,215,841.000000000000000,92.986558168371857,3364.000000000000000,4,718,1,25.0000000,718,1,25.0000000,784,933
4164,4.000000000000000,0.000277777777778,718,933,215,841.000000000000000,92.986558168371857,3364.000000000000000,4,718,1,25.0000000,718,1,25.0000000,784,933
4165,5.000000000000000,0.000347222222222,395,933,538,751.799999999999955,196.834346596319421,3759.000000000000000,5,395,1,20.0000000,395,1,20.0000000,784,933
4166,4.000000000000000,0.000277777777778,290,767,477,415.250000000000000,203.220785108216717,1661.000000000000000,4,290,1,25.0000000,290,1,25.0000000,294,767
4167,3.000000000000000,0.000208333333333,435,2012,1577,1210.333333333333258,644.076772511545300,3631.000000000000000,3,435,1,33.3333015,435,1,33.3333015,1184,2012
4168,4.000000000000000,0.000277777777778,894,2682,1788,1854.750000000000000,832.162056032357214,7419.000000000000000,4,894,1,25.0000000,894,1,25.0000000,1162,2682
4169,4.000000000000000,0.000277777777778,337,1042,705,592.250000000000000,268.510125507400573,2369.000000000000000,4,337,1,25.0000000,337,1,25.0000000,463,1042
4170,4.000000000000000,0.000277777777778,355,644,289,556.750000000000000,118.060101219675403,2227.000000000000000,4,355,1,25.0000000,355,1,25.0000000,593,644
4171,4.000000000000000,0.000277777777778,137,877,740,516.500000000000000,262.263703169157566,2066.000000000000000,4,137,1,25.0000000,137,1,25.0000000,504,877
4172,4.000000000000000,0.000277777777778,968,1390,422,1101.500000000000000,168.247585421009830,4406.000000000000000,4,968,1,25.0000000,968,1,25.0000000,1015,1390
4173,4.000000000000000,0.000277777777778,625,1405,780,959.750000000000000,304.356185250111139,3839.000000000000000,4,625,1,25.0000000,625,1,25.0000000,740,1405
4174,4.000000000000000,0.000277777777778,625,1405,780,959.750000000000000,304.356185250111139,3839.000000000000000,4,625,1,25.0000000,625,1,25.0000000,740,1405
4175,4.000000000000000,0.000277777777778,625,988,363,794.750000000000000,140.745115368171838,3179.000000000000000,4,625,1,25.0000000,625,1,25.0000000,703,988
4176,4.000000000000000,0.000277777777778,332,1016,684,680.750000000000000,272.219924876927394,2723.000000000000000,4,332,1,25.0000000,332,1,25.0000000,511,1016
4177,4.000000000000000,0.000277777777778,1424,2472,1048,1966.000000000000000,419.495530369514142,7864.000000000000000,4,1424,1,25.0000000,1424,1,25.0000000,1707,2472
4178,4.000000000000000,0.000277777777778,716,977,261,797.000000000000000,105.714237451726447,3188.000000000000000,4,716,1,25.0000000,716,1,25.0000000,727,977
4179,6.000000000000000,0.000416666666667,477,1202,725,966.666666666666629,259.618737553530366,5800.000000000000000,6,477,1,16.6667004,477,1,16.6667004,1094,1160
4180,3.000000000000000,0.000208333333333,246,1098,852,656.666666666666742,348.502829575632290,1970.000000000000000,3,246,1,33.3333015,246,1,33.3333015,626,1098
4181,4.000000000000000,0.000277777777778,353,1375,1022,805.500000000000000,373.774330311753772,3222.000000000000000,4,353,1,25.0000000,353,1,25.0000000,640,1375
4182,4.000000000000000,0.000277777777778,798,1774,976,1149.500000000000000,374.187453023214005,4598.000000000000000,4,798,1,25.0000000,798,1,25.0000000,945,1774
4183,4.000000000000000,0.000277777777778,460,1118,658,675.000000000000000,259.935568939689347,2700.000000000000000,4,460,1,25.0000000,460,1,25.0000000,531,1118
4184,4.000000000000000,0.000277777777778,418,1859,1441,1208.000000000000000,647.914732044271432,4832.000000000000000,4,418,1,25.0000000,418,1,25.0000000,720,1859
4185,5.000000000000000,0.000347222222222,518,922,404,745.399999999999977,175.846069049040750,3727.000000000000000,4,871,2,40.0000000,518,1,20.0000000,871,922
4186,5.000000000000000,0.000347222222222,885,3588,2703,2289.599999999999909,916.010611292249223,11448.000000000000000,5,885,1,20.0000000,885,1,20.0000000,2121,3588
4187,3.000000000000000,0.000208333333333,885,2912,2027,1913.000000000000000,827.773318407078591,5739.000000000000000,3,885,1,33.3333015,885,1,33.3333015,1942,2912
4188,4.000000000000000,0.000277777777778,1045,1167,122,1100.750000000000000,47.044526780487438,4403.000000000000000,4,1045,1,25.0000000,1045,1,25.0000000,1070,1167
4189,5.000000000000000,0.000347222222222,613,1310,697,977.799999999999955,305.625522494440872,4889.000000000000000,5,613,1,20.0000000,613,1,20.0000000,1059,1310
4190,4.000000000000000,0.000277777777778,489,682,193,619.000000000000000,76.311860152927736,2476.000000000000000,4,489,1,25.0000000,489,1,25.0000000,643,682
4191,4.000000000000000,0.000277777777778,669,1698,1029,1055.500000000000000,389.541076139603035,4222.000000000000000,4,669,1,25.0000000,669,1,25.0000000,850,1698
4192,4.000000000000000,0.000277777777778,669,1698,1029,1055.500000000000000,389.541076139603035,4222.000000000000000,4,669,1,25.0000000,669,1,25.0000000,850,1698
4193,4.000000000000000,0.000277777777778,313,1029,716,756.250000000000000,283.777531703974034,3025.000000000000000,4,313,1,25.0000000,313,1,25.0000000,706,1029
4194,4.000000000000000,0.000277777777778,513,1394,881,1058.500000000000000,337.218401040038145,4234.000000000000000,4,513,1,25.0000000,513,1,25.0000000,1057,1394
4195,4.000000000000000,0.000277777777778,374,1607,1233,795.750000000000000,500.860946271517548,3183.000000000000000,4,374,1,25.0000000,374,1,25.0000000,387,1607
4196,4.000000000000000,0.000277777777778,537,1454,917,983.000000000000000,347.120296151060586,3932.000000000000000,4,537,1,25.0000000,537,1,25.0000000,796,1454
4197,4.000000000000000,0.000277777777778,488,3533,3045,1529.500000000000000,1221.963686039810455,6118.000000000000000,4,488,1,25.0000000,488,1,25.0000000,595,3533
4198,4.000000000000000,0.000277777777778,1015,1712,697,1298.250000000000000,255.169918877598121,5193.000000000000000,4,1015,1,25.0000000,1015,1,25.0000000,1217,1712
4199,5.000000000000000,0.000347222222222,333,1020,687,687.200000000000045,225.111883293619144,3436.000000000000000,5,333,1,20.0000000,333,1,20.0000000,659,1020
4200,4.000000000000000,0.000277777777778,898,1650,752,1359.250000000000000,284.948569920959585,5437.000000000000000,4,898,1,25.0000000,898,1,25.0000000,1364,1650
4201,4.000000000000000,0.000277777777778,384,2057,1673,984.500000000000000,641.442320088096494,3938.000000000000000,4,384,1,25.0000000,384,1,25.0000000,640,2057
4202,4.000000000000000,0.000277777777778,895,2150,1255,1411.750000000000000,529.346944356912331,5647.000000000000000,4,895,1,25.0000000,895,1,25.0000000,924,2150
4203,4.000000000000000,0.000277777777778,554,2138,1584,1311.250000000000000,563.573142990330894,5245.000000000000000,4,554,1,25.0000000,554,1,25.0000000,1202,2138
4204,4.000000000000000,0.000277777777778,391,602,211,503.750000000000000,78.931536789802848,2015.000000000000000,4,391,1,25.0000000,391,1,25.0000000,476,602
4205,4.000000000000000,0.000277777777778,208,609,401,311.000000000000000,172.108977104624046,1244.000000000000000,3,208,2,50.0000000,219,1,25.0000000,208,609
4206,4.000000000000000,0.000277777777778,251,616,365,411.500000000000000,132.673471349776634,1646.000000000000000,4,251,1,25.0000000,251,1,25.0000000,359,616
4207,5.000000000000000,0.000347222222222,394,1434,1040,930.000000000000000,418.368736881713005,4650.000000000000000,5,394,1,20.0000000,394,1,20.0000000,843,1434
4208,4.000000000000000,0.000277777777778,316,1440,1124,866.500000000000000,502.659676122921155,3466.000000000000000,4,316,1,25.0000000,316,1,25.0000000,420,1440
4209,4.000000000000000,0.000277777777778,351,1542,1191,1094.750000000000000,461.771250187795886,4379.000000000000000,4,351,1,25.0000000,351,1,25.0000000,1076,1542
4210,4.000000000000000,0.000277777777778,351,1542,1191,1094.750000000000000,461.771250187795886,4379.000000000000000,4,351,1,25.0000000,351,1,25.0000000,1076,1542
4211,4.000000000000000,0.000277777777778,221,409,188,323.750000000000000,76.633462012361150,1295.000000000000000,4,221,1,25.0000000,221,1,25.0000000,280,409
4212,4.000000000000000,0.000277777777778,578,28771,28193,7898.500000000000000,12052.931313585089811,31594.000000000000000,4,578,1,25.0000000,578,1,25.0000000,1041,28771
4213,5.000000000000000,0.000347222222222,243,1265,1022,840.799999999999955,362.466770890794919,4204.000000000000000,5,243,1,20.0000000,243,1,20.0000000,994,1265
4214,4.000000000000000,0.000277777777778,667,1634,967,1286.500000000000000,380.035853571738699,5146.000000000000000,4,667,1,25.0000000,667,1,25.0000000,1288,1634
4215,5.000000000000000,0.000347222222222,322,1713,1391,1303.400000000000091,511.145615260465718,6517.000000000000000,5,322,1,20.0000000,322,1,20.0000000,1577,1713
4216,3.000000000000000,0.000208333333333,208,752,544,436.333333333333314,230.512954564862184,1309.000000000000000,3,208,1,33.3333015,208,1,33.3333015,349,752
4217,3.000000000000000,0.000208333333333,210,752,542,437.000000000000000,229.853576580106022,1311.000000000000000,3,210,1,33.3333015,210,1,33.3333015,349,752
4218,5.000000000000000,0.000347222222222,421,717,296,570.399999999999977,94.736687719172451,2852.000000000000000,5,421,1,20.0000000,421,1,20.0000000,577,717
4219,5.000000000000000,0.000347222222222,1356,2380,1024,1792.199999999999818,331.768835184982379,8961.000000000000000,5,1356,1,20.0000000,1356,1,20.0000000,1721,2380
4220,3.000000000000000,0.000208333333333,1077,3735,2658,2219.666666666666515,1116.662089542858212,6659.000000000000000,3,1077,1,33.3333015,1077,1,33.3333015,1847,3735
4221,4.000000000000000,0.000277777777778,1077,1847,770,1461.500000000000000,360.867357903149809,5846.000000000000000,4,1077,1,25.0000000,1077,1,25.0000000,1126,1847
4222,4.000000000000000,0.000277777777778,652,1859,1207,1363.750000000000000,512.488719388046661,5455.000000000000000,4,652,1,25.0000000,652,1,25.0000000,1101,1859
4223,4.000000000000000,0.000277777777778,349,2664,2315,1686.750000000000000,981.343562418381566,6747.000000000000000,4,349,1,25.0000000,349,1,25.0000000,1145,2664
4224,4.000000000000000,0.000277777777778,756,1912,1156,1251.500000000000000,443.080410309460660,5006.000000000000000,4,756,1,25.0000000,756,1,25.0000000,957,1912
4225,4.000000000000000,0.000277777777778,909,1308,399,1142.500000000000000,165.822947748494698,4570.000000000000000,4,909,1,25.0000000,909,1,25.0000000,1063,1308
4226,4.000000000000000,0.000277777777778,689,1960,1271,1125.000000000000000,491.667062146733599,4500.000000000000000,4,689,1,25.0000000,689,1,25.0000000,922,1960
4227,4.000000000000000,0.000277777777778,349,1258,909,634.750000000000000,363.089090307048480,2539.000000000000000,4,349,1,25.0000000,349,1,25.0000000,454,1258
4228,4.000000000000000,0.000277777777778,349,1258,909,634.750000000000000,363.089090307048480,2539.000000000000000,4,349,1,25.0000000,349,1,25.0000000,454,1258
4229,5.000000000000000,0.000347222222222,526,969,443,758.799999999999955,188.820973411324189,3794.000000000000000,5,526,1,20.0000000,526,1,20.0000000,853,969
4230,4.000000000000000,0.000277777777778,480,691,211,585.250000000000000,86.888937730875725,2341.000000000000000,4,480,1,25.0000000,480,1,25.0000000,522,691
4231,5.000000000000000,0.000347222222222,972,1942,970,1486.400000000000091,391.108476001224005,7432.000000000000000,5,972,1,20.0000000,972,1,20.0000000,1579,1942
4232,5.000000000000000,0.000347222222222,512,813,301,656.199999999999932,124.953431325434181,3281.000000000000000,5,512,1,20.0000000,512,1,20.0000000,619,813
4233,5.000000000000000,0.000347222222222,1044,2379,1335,1730.599999999999909,520.190195986045069,8653.000000000000000,5,1044,1,20.0000000,1044,1,20.0000000,1487,2379
4234,4.000000000000000,0.000277777777778,273,943,670,662.000000000000000,275.936586918081616,2648.000000000000000,4,273,1,25.0000000,273,1,25.0000000,531,943
4235,3.000000000000000,0.000208333333333,531,7668,7137,3047.333333333333485,3271.631227520743778,9142.000000000000000,3,531,1,33.3333015,531,1,33.3333015,943,7668
4236,4.000000000000000,0.000277777777778,237,737,500,487.000000000000000,201.920776543673185,1948.000000000000000,4,237,1,25.0000000,237,1,25.0000000,349,737
4237,3.000000000000000,0.000208333333333,1012,2194,1182,1532.000000000000000,492.885382213755634,4596.000000000000000,3,1012,1,33.3333015,1012,1,33.3333015,1390,2194
4238,4.000000000000000,0.000277777777778,801,1831,1030,1282.500000000000000,425.275498941568458,5130.000000000000000,4,801,1,25.0000000,801,1,25.0000000,942,1831
4239,4.000000000000000,0.000277777777778,755,1016,261,847.250000000000000,100.380214683970465,3389.000000000000000,4,755,1,25.0000000,755,1,25.0000000,795,1016
4240,4.000000000000000,0.000277777777778,731,1603,872,1021.000000000000000,351.178017535266576,4084.000000000000000,4,731,1,25.0000000,731,1,25.0000000,757,1603
4241,4.000000000000000,0.000277777777778,728,2561,1833,1638.250000000000000,857.463228074533845,6553.000000000000000,4,728,1,25.0000000,728,1,25.0000000,838,2561
4242,4.000000000000000,0.000277777777778,649,1214,565,885.500000000000000,237.811374833080663,3542.000000000000000,4,649,1,25.0000000,649,1,25.0000000,669,1214
4243,4.000000000000000,0.000277777777778,300,990,690,544.750000000000000,264.315507490574589,2179.000000000000000,4,300,1,25.0000000,300,1,25.0000000,420,990
4244,4.000000000000000,0.000277777777778,949,1622,673,1299.250000000000000,239.344286541375368,5197.000000000000000,4,949,1,25.0000000,949,1,25.0000000,1282,1622
4245,4.000000000000000,0.000277777777778,48,799,751,426.000000000000000,275.059084561844656,1704.000000000000000,4,48,1,25.0000000,48,1,25.0000000,327,799
4246,4.000000000000000,0.000277777777778,42,372,330,216.250000000000000,146.451997255073309,865.000000000000000,4,42,1,25.0000000,42,1,25.0000000,101,372
4247,5.000000000000000,0.000347222222222,223,1192,969,552.799999999999955,355.570752453010357,2764.000000000000000,4,223,2,40.0000000,509,1,20.0000000,509,1192
4248,4.000000000000000,0.000277777777778,328,1231,903,795.000000000000000,327.749141875306805,3180.000000000000000,4,328,1,25.0000000,328,1,25.0000000,708,1231
4249,4.000000000000000,0.000277777777778,361,816,455,552.250000000000000,198.001736103499866,2209.000000000000000,3,361,2,50.0000000,671,1,25.0000000,361,816
4250,4.000000000000000,0.000277777777778,290,604,314,506.250000000000000,126.929852674617095,2025.000000000000000,4,290,1,25.0000000,290,1,25.0000000,542,604
4251,4.000000000000000,0.000277777777778,103,4655,4552,1601.250000000000000,1796.917690797216210,6405.000000000000000,4,103,1,25.0000000,103,1,25.0000000,563,4655
4252,3.000000000000000,0.000208333333333,818,1426,608,1041.666666666666742,272.979038674319384,3125.000000000000000,3,818,1,33.3333015,818,1,33.3333015,881,1426
4253,4.000000000000000,0.000277777777778,225,604,379,373.000000000000000,143.312595399008814,1492.000000000000000,4,225,1,25.0000000,225,1,25.0000000,290,604
4254,4.000000000000000,0.000277777777778,655,1695,1040,1017.000000000000000,410.156677380729775,4068.000000000000000,4,655,1,25.0000000,655,1,25.0000000,732,1695
4255,4.000000000000000,0.000277777777778,717,1508,791,1013.500000000000000,317.633830062227446,4054.000000000000000,4,717,1,25.0000000,717,1,25.0000000,754,1508
4256,4.000000000000000,0.000277777777778,332,3735,3403,1342.250000000000000,1404.457969289220046,5369.000000000000000,4,332,1,25.0000000,332,1,25.0000000,344,3735
4257,4.000000000000000,0.000277777777778,662,709,47,678.750000000000000,17.935648859185459,2715.000000000000000,3,672,2,50.0000000,662,1,25.0000000,672,709
4258,4.000000000000000,0.000277777777778,514,971,457,712.250000000000000,173.387391410102254,2849.000000000000000,4,514,1,25.0000000,514,1,25.0000000,604,971
4259,4.000000000000000,0.000277777777778,1014,1824,810,1346.000000000000000,323.480293062807789,5384.000000000000000,4,1014,1,25.0000000,1014,1,25.0000000,1087,1824
4260,4.000000000000000,0.000277777777778,428,1351,923,670.750000000000000,393.070842851514499,2683.000000000000000,4,428,1,25.0000000,428,1,25.0000000,434,1351
4261,4.000000000000000,0.000277777777778,1642,3735,2093,2287.250000000000000,842.225140624524443,9149.000000000000000,4,1642,1,25.0000000,1642,1,25.0000000,1847,3735
4262,4.000000000000000,0.000277777777778,191,288,97,248.000000000000000,35.839921874914850,992.000000000000000,4,191,1,25.0000000,191,1,25.0000000,248,288
4263,4.000000000000000,0.000277777777778,93,1625,1532,1115.750000000000000,622.305943648299035,4463.000000000000000,4,93,1,25.0000000,93,1,25.0000000,1136,1625
4264,5.000000000000000,0.000347222222222,545,994,449,774.399999999999977,183.527218689762748,3872.000000000000000,5,545,1,20.0000000,545,1,20.0000000,703,994
4265,5.000000000000000,0.000347222222222,440,1239,799,797.000000000000000,317.154221160620864,3985.000000000000000,5,440,1,20.0000000,440,1,20.0000000,835,1239
4266,6.000000000000000,0.000416666666667,128,1118,990,652.833333333333258,382.329446362107376,3917.000000000000000,6,128,1,16.6667004,128,1,16.6667004,635,1047
4267,4.000000000000000,0.000277777777778,1077,3735,2658,2075.250000000000000,998.883970989624004,8301.000000000000000,4,1077,1,25.0000000,1077,1,25.0000000,1642,3735
4268,4.000000000000000,0.000277777777778,1254,1689,435,1467.500000000000000,154.742528091019636,5870.000000000000000,4,1254,1,25.0000000,1254,1,25.0000000,1440,1689
4269,4.000000000000000,0.000277777777778,1023,1370,347,1266.250000000000000,143.157911063273048,5065.000000000000000,3,1370,2,50.0000000,1023,1,25.0000000,1302,1370
4270,4.000000000000000,0.000277777777778,135,4081,3946,1711.500000000000000,1468.354436095045912,6846.000000000000000,4,135,1,25.0000000,135,1,25.0000000,991,4081
4271,4.000000000000000,0.000277777777778,637,1959,1322,1065.500000000000000,522.204222503035794,4262.000000000000000,4,637,1,25.0000000,637,1,25.0000000,814,1959
4272,4.000000000000000,0.000277777777778,1429,1537,108,1481.000000000000000,52.076866265166146,5924.000000000000000,3,1429,2,50.0000000,1529,1,25.0000000,1429,1537
4273,4.000000000000000,0.000277777777778,895,2150,1255,1411.750000000000000,529.346944356912331,5647.000000000000000,4,895,1,25.0000000,895,1,25.0000000,924,2150
4274,4.000000000000000,0.000277777777778,382,2330,1948,1348.750000000000000,712.966119461507105,5395.000000000000000,4,382,1,25.0000000,382,1,25.0000000,1081,2330
4275,4.000000000000000,0.000277777777778,894,2211,1317,1632.000000000000000,478.786486860270543,6528.000000000000000,4,894,1,25.0000000,894,1,25.0000000,1601,2211
4276,4.000000000000000,0.000277777777778,135,1639,1504,845.000000000000000,533.717153556076028,3380.000000000000000,4,135,1,25.0000000,135,1,25.0000000,777,1639
4277,4.000000000000000,0.000277777777778,956,2116,1160,1600.250000000000000,416.975044217276945,6401.000000000000000,4,956,1,25.0000000,956,1,25.0000000,1609,2116
4278,4.000000000000000,0.000277777777778,857,1903,1046,1572.250000000000000,417.936224201731534,6289.000000000000000,4,857,1,25.0000000,857,1,25.0000000,1721,1903
4279,5.000000000000000,0.000347222222222,449,1060,611,705.000000000000000,267.101478842779898,3525.000000000000000,5,449,1,20.0000000,449,1,20.0000000,524,1060
4280,4.000000000000000,0.000277777777778,657,1101,444,855.250000000000000,161.202318531713445,3421.000000000000000,4,657,1,25.0000000,657,1,25.0000000,792,1101
4281,4.000000000000000,0.000277777777778,850,1401,551,1036.750000000000000,214.166261348513984,4147.000000000000000,4,850,1,25.0000000,850,1,25.0000000,939,1401
4282,4.000000000000000,0.000277777777778,850,1698,848,1226.500000000000000,341.740032773451958,4906.000000000000000,4,850,1,25.0000000,850,1,25.0000000,957,1698
4283,4.000000000000000,0.000277777777778,609,897,288,763.000000000000000,117.951261120854468,3052.000000000000000,4,609,1,25.0000000,609,1,25.0000000,690,897
4284,4.000000000000000,0.000277777777778,860,2647,1787,1709.250000000000000,633.830961298041984,6837.000000000000000,4,860,1,25.0000000,860,1,25.0000000,1630,2647
4285,3.000000000000000,0.000208333333333,380,692,312,551.333333333333371,129.206123005925008,1654.000000000000000,3,380,1,33.3333015,380,1,33.3333015,582,692
4286,4.000000000000000,0.000277777777778,501,1176,675,808.000000000000000,290.600240880836168,3232.000000000000000,4,501,1,25.0000000,501,1,25.0000000,547,1176
4287,4.000000000000000,0.000277777777778,651,877,226,784.000000000000000,82.371111440844345,3136.000000000000000,4,651,1,25.0000000,651,1,25.0000000,803,877
4288,4.000000000000000,0.000277777777778,178,1428,1250,1037.000000000000000,512.243106346976674,4148.000000000000000,3,1428,2,50.0000000,178,1,25.0000000,1114,1428
4289,4.000000000000000,0.000277777777778,1037,2145,1108,1764.250000000000000,433.850996887180145,7057.000000000000000,4,1037,1,25.0000000,1037,1,25.0000000,1840,2145
4290,3.000000000000000,0.000208333333333,454,991,537,656.333333333333371,238.364333648210817,1969.000000000000000,3,454,1,33.3333015,454,1,33.3333015,524,991
4291,4.000000000000000,0.000277777777778,552,943,391,725.250000000000000,155.605872318495756,2901.000000000000000,4,552,1,25.0000000,552,1,25.0000000,607,943
4292,4.000000000000000,0.000277777777778,1036,2248,1212,1486.500000000000000,467.707440607908211,5946.000000000000000,4,1036,1,25.0000000,1036,1,25.0000000,1183,2248
4293,4.000000000000000,0.000277777777778,579,881,302,732.500000000000000,106.823452481185058,2930.000000000000000,4,579,1,25.0000000,579,1,25.0000000,732,881
4294,4.000000000000000,0.000277777777778,1012,1957,945,1390.750000000000000,367.474744030116995,5563.000000000000000,4,1012,1,25.0000000,1012,1,25.0000000,1126,1957
4295,4.000000000000000,0.000277777777778,444,740,296,620.000000000000000,115.102128564158193,2480.000000000000000,4,444,1,25.0000000,444,1,25.0000000,593,740
4296,4.000000000000000,0.000277777777778,584,1857,1273,1039.000000000000000,510.816503257285149,4156.000000000000000,4,584,1,25.0000000,584,1,25.0000000,632,1857
4297,4.000000000000000,0.000277777777778,678,1106,428,914.500000000000000,191.969398603006510,3658.000000000000000,4,678,1,25.0000000,678,1,25.0000000,773,1106
4298,4.000000000000000,0.000277777777778,653,1777,1124,1105.500000000000000,461.342334931447624,4422.000000000000000,4,653,1,25.0000000,653,1,25.0000000,703,1777
4299,5.000000000000000,0.000347222222222,575,1123,548,895.600000000000023,198.092503644130858,4478.000000000000000,5,575,1,20.0000000,575,1,20.0000000,877,1123
4300,4.000000000000000,0.000277777777778,578,1822,1244,1223.750000000000000,506.445641209399696,4895.000000000000000,4,578,1,25.0000000,578,1,25.0000000,894,1822
4301,4.000000000000000,0.000277777777778,482,1106,624,809.500000000000000,254.468563873811348,3238.000000000000000,4,482,1,25.0000000,482,1,25.0000000,647,1106
4302,4.000000000000000,0.000277777777778,669,1209,540,995.500000000000000,200.016874288145971,3982.000000000000000,4,669,1,25.0000000,669,1,25.0000000,1025,1209
4303,3.000000000000000,0.000208333333333,194,2907,2713,1211.666666666666742,1206.790877584936879,3635.000000000000000,3,194,1,33.3333015,194,1,33.3333015,534,2907
4304,4.000000000000000,0.000277777777778,233,893,660,479.500000000000000,262.653288576404464,1918.000000000000000,4,233,1,25.0000000,233,1,25.0000000,273,893
4305,4.000000000000000,0.000277777777778,593,825,232,680.000000000000000,87.732548122119425,2720.000000000000000,4,593,1,25.0000000,593,1,25.0000000,635,825
4306,4.000000000000000,0.000277777777778,625,740,115,692.750000000000000,41.930746475587590,2771.000000000000000,3,703,2,50.0000000,625,1,25.0000000,703,740
4307,4.000000000000000,0.000277777777778,275,1032,757,726.250000000000000,297.448630018697543,2905.000000000000000,4,275,1,25.0000000,275,1,25.0000000,647,1032
4308,4.000000000000000,0.000277777777778,449,601,152,516.500000000000000,55.572025336494626,2066.000000000000000,4,449,1,25.0000000,449,1,25.0000000,492,601
4309,4.000000000000000,0.000277777777778,783,1561,778,1137.750000000000000,342.081404785469147,4551.000000000000000,4,783,1,25.0000000,783,1,25.0000000,820,1561
4310,4.000000000000000,0.000277777777778,879,1818,939,1306.000000000000000,413.542621745328688,5224.000000000000000,4,879,1,25.0000000,879,1,25.0000000,920,1818
4311,4.000000000000000,0.000277777777778,878,1475,597,1072.500000000000000,242.769952836013061,4290.000000000000000,4,878,1,25.0000000,878,1,25.0000000,884,1475
4312,4.000000000000000,0.000277777777778,878,1475,597,1072.500000000000000,242.769952836013061,4290.000000000000000,4,878,1,25.0000000,878,1,25.0000000,884,1475
4313,3.000000000000000,0.000208333333333,351,1542,1191,902.000000000000000,490.279512115283069,2706.000000000000000,3,351,1,33.3333015,351,1,33.3333015,813,1542
4314,4.000000000000000,0.000277777777778,181,2829,2648,1508.750000000000000,1062.834976607375211,6035.000000000000000,4,181,1,25.0000000,181,1,25.0000000,801,2829
4315,4.000000000000000,0.000277777777778,899,948,49,911.250000000000000,21.217622392718749,3645.000000000000000,2,899,3,75.0000000,948,1,25.0000000,899,948
4316,4.000000000000000,0.000277777777778,237,2182,1945,1471.000000000000000,792.199785407696254,5884.000000000000000,4,237,1,25.0000000,237,1,25.0000000,1317,2182
4317,4.000000000000000,0.000277777777778,871,1639,768,1170.750000000000000,284.484072489129005,4683.000000000000000,4,871,1,25.0000000,871,1,25.0000000,1072,1639
4318,4.000000000000000,0.000277777777778,333,948,615,673.250000000000000,235.438288092654972,2693.000000000000000,4,333,1,25.0000000,333,1,25.0000000,587,948
4319,5.000000000000000,0.000347222222222,206,697,491,428.000000000000000,195.289528649131626,2140.000000000000000,5,206,1,20.0000000,206,1,20.0000000,400,697
4320,4.000000000000000,0.000277777777778,353,1367,1014,803.500000000000000,370.730697407161017,3214.000000000000000,4,353,1,25.0000000,353,1,25.0000000,640,1367
4321,4.000000000000000,0.000277777777778,231,1058,827,554.750000000000000,308.227493095603052,2219.000000000000000,4,231,1,25.0000000,231,1,25.0000000,411,1058
4322,4.000000000000000,0.000277777777778,621,858,237,724.500000000000000,89.371416012056116,2898.000000000000000,4,621,1,25.0000000,621,1,25.0000000,671,858
4323,5.000000000000000,0.000347222222222,1215,3669,2454,2626.800000000000182,919.468629154904875,13134.000000000000000,5,1215,1,20.0000000,1215,1,20.0000000,2397,3669
4324,4.000000000000000,0.000277777777778,540,1079,539,841.500000000000000,193.887209480151114,3366.000000000000000,4,540,1,25.0000000,540,1,25.0000000,851,1079
4325,4.000000000000000,0.000277777777778,391,1506,1115,982.000000000000000,414.851178135003011,3928.000000000000000,4,391,1,25.0000000,391,1,25.0000000,839,1506
4326,4.000000000000000,0.000277777777778,147,1395,1248,736.000000000000000,501.355662180053571,2944.000000000000000,4,147,1,25.0000000,147,1,25.0000000,368,1395
4327,3.000000000000000,0.000208333333333,170,1280,1110,804.333333333333371,466.837825754892663,2413.000000000000000,3,170,1,33.3333015,170,1,33.3333015,963,1280
4328,4.000000000000000,0.000277777777778,443,1521,1078,978.750000000000000,381.393743393884279,3915.000000000000000,4,443,1,25.0000000,443,1,25.0000000,956,1521
4329,4.000000000000000,0.000277777777778,401,481,80,450.000000000000000,33.511192160232071,1800.000000000000000,3,481,2,50.0000000,401,1,25.0000000,437,481
4330,4.000000000000000,0.000277777777778,448,619,171,518.500000000000000,66.642704026772506,2074.000000000000000,4,448,1,25.0000000,448,1,25.0000000,470,619
4331,4.000000000000000,0.000277777777778,769,1280,511,916.500000000000000,210.984004133014764,3666.000000000000000,4,769,1,25.0000000,769,1,25.0000000,788,1280
4332,4.000000000000000,0.000277777777778,341,899,558,615.750000000000000,264.695461804693593,2463.000000000000000,4,341,1,25.0000000,341,1,25.0000000,362,899
4333,4.000000000000000,0.000277777777778,155,751,596,487.000000000000000,220.278233150713305,1948.000000000000000,4,155,1,25.0000000,155,1,25.0000000,444,751
4334,4.000000000000000,0.000277777777778,431,931,500,621.500000000000000,195.537080882373829,2486.000000000000000,4,431,1,25.0000000,431,1,25.0000000,479,931
4335,4.000000000000000,0.000277777777778,410,709,299,569.500000000000000,106.678254578897196,2278.000000000000000,4,410,1,25.0000000,410,1,25.0000000,565,709
4336,4.000000000000000,0.000277777777778,695,1551,856,1122.000000000000000,356.703658517823385,4488.000000000000000,4,695,1,25.0000000,695,1,25.0000000,854,1551
4337,4.000000000000000,0.000277777777778,222,854,632,611.500000000000000,235.330087324166868,2446.000000000000000,4,222,1,25.0000000,222,1,25.0000000,675,854
4338,4.000000000000000,0.000277777777778,1492,4820,3328,2512.500000000000000,1341.312137423649801,10050.000000000000000,4,1492,1,25.0000000,1492,1,25.0000000,1835,4820
4339,4.000000000000000,0.000277777777778,582,2211,1629,1554.000000000000000,602.176469151693141,6216.000000000000000,4,582,1,25.0000000,582,1,25.0000000,1601,2211
4340,4.000000000000000,0.000277777777778,50,1375,1325,496.250000000000000,527.770487522748795,1985.000000000000000,4,50,1,25.0000000,50,1,25.0000000,123,1375
4341,4.000000000000000,0.000277777777778,1370,2459,1089,1744.000000000000000,444.990449335713265,6976.000000000000000,3,1370,2,50.0000000,1777,1,25.0000000,1370,2459
4342,4.000000000000000,0.000277777777778,332,1274,942,787.500000000000000,355.630777633207686,3150.000000000000000,4,332,1,25.0000000,332,1,25.0000000,597,1274
4343,4.000000000000000,0.000277777777778,451,2509,2058,1822.500000000000000,804.317567879752232,7290.000000000000000,4,451,1,25.0000000,451,1,25.0000000,2145,2509
4344,4.000000000000000,0.000277777777778,328,2307,1979,1690.500000000000000,797.536989737780232,6762.000000000000000,4,328,1,25.0000000,328,1,25.0000000,1942,2307
4345,4.000000000000000,0.000277777777778,410,789,379,546.750000000000000,149.350887175135313,2187.000000000000000,4,410,1,25.0000000,410,1,25.0000000,438,789
4346,4.000000000000000,0.000277777777778,754,5915,5161,2201.000000000000000,2148.101603742243697,8804.000000000000000,4,754,1,25.0000000,754,1,25.0000000,1060,5915
4347,4.000000000000000,0.000277777777778,562,2388,1826,1253.750000000000000,731.006968161042892,5015.000000000000000,4,562,1,25.0000000,562,1,25.0000000,662,2388
4348,4.000000000000000,0.000277777777778,864,2241,1377,1494.500000000000000,530.221887515028925,5978.000000000000000,4,864,1,25.0000000,864,1,25.0000000,1151,2241
4349,4.000000000000000,0.000277777777778,345,2915,2570,1240.750000000000000,1045.951331324741886,4963.000000000000000,4,345,1,25.0000000,345,1,25.0000000,368,2915
4350,4.000000000000000,0.000277777777778,193,2077,1884,1222.000000000000000,679.531824125993353,4888.000000000000000,4,193,1,25.0000000,193,1,25.0000000,1164,2077
4351,4.000000000000000,0.000277777777778,629,1084,455,851.000000000000000,206.747430455616552,3404.000000000000000,4,629,1,25.0000000,629,1,25.0000000,662,1084
4352,3.000000000000000,0.000208333333333,662,1084,422,925.000000000000000,187.319691080961007,2775.000000000000000,3,662,1,33.3333015,662,1,33.3333015,1029,1084
4353,5.000000000000000,0.000347222222222,265,5283,5018,1586.200000000000045,1860.854255442913427,7931.000000000000000,5,265,1,20.0000000,265,1,20.0000000,823,5283
4354,4.000000000000000,0.000277777777778,419,849,430,657.750000000000000,160.289386735366861,2631.000000000000000,4,419,1,25.0000000,419,1,25.0000000,618,849
4355,3.000000000000000,0.000208333333333,492,857,365,729.666666666666629,168.198956265753594,2189.000000000000000,3,492,1,33.3333015,492,1,33.3333015,840,857
4356,4.000000000000000,0.000277777777778,466,621,155,517.250000000000000,61.352974663010428,2069.000000000000000,4,466,1,25.0000000,466,1,25.0000000,479,621
4357,4.000000000000000,0.000277777777778,1093,2647,1554,1791.250000000000000,563.007271267432202,7165.000000000000000,4,1093,1,25.0000000,1093,1,25.0000000,1579,2647
4358,4.000000000000000,0.000277777777778,566,1145,579,903.250000000000000,210.373923051313568,3613.000000000000000,4,566,1,25.0000000,566,1,25.0000000,939,1145
4359,4.000000000000000,0.000277777777778,224,990,766,528.250000000000000,308.418850753322147,2113.000000000000000,4,224,1,25.0000000,224,1,25.0000000,273,990
4360,4.000000000000000,0.000277777777778,84,815,731,480.250000000000000,266.498006559148564,1921.000000000000000,4,84,1,25.0000000,84,1,25.0000000,430,815
4361,4.000000000000000,0.000277777777778,166,790,624,494.750000000000000,222.442548762596232,1979.000000000000000,4,166,1,25.0000000,166,1,25.0000000,479,790
4362,4.000000000000000,0.000277777777778,416,1282,866,857.750000000000000,307.638078754890159,3431.000000000000000,4,416,1,25.0000000,416,1,25.0000000,826,1282
4363,4.000000000000000,0.000277777777778,555,1577,1022,1091.500000000000000,414.515681247404700,4366.000000000000000,4,555,1,25.0000000,555,1,25.0000000,832,1577
4364,3.000000000000000,0.000208333333333,458,1696,1238,1221.666666666666742,545.249993631871234,3665.000000000000000,3,458,1,33.3333015,458,1,33.3333015,1511,1696
4365,4.000000000000000,0.000277777777778,179,632,453,385.250000000000000,197.947436204665195,1541.000000000000000,4,179,1,25.0000000,179,1,25.0000000,203,632
4366,5.000000000000000,0.000347222222222,583,1381,798,960.799999999999955,278.883775074850860,4804.000000000000000,5,583,1,20.0000000,583,1,20.0000000,957,1381
4367,3.000000000000000,0.000208333333333,1250,1500,250,1375.000000000000000,102.062072615965747,4125.000000000000000,3,1250,1,33.3333015,1250,1,33.3333015,1375,1500
4368,3.000000000000000,0.000208333333333,489,1500,1011,835.000000000000000,470.355184940062088,2505.000000000000000,3,489,1,33.3333015,489,1,33.3333015,516,1500
4369,4.000000000000000,0.000277777777778,240,819,579,505.500000000000000,226.405057364008542,2022.000000000000000,4,240,1,25.0000000,240,1,25.0000000,349,819
4370,4.000000000000000,0.000277777777778,509,1743,1234,1159.250000000000000,478.957396330821894,4637.000000000000000,4,509,1,25.0000000,509,1,25.0000000,917,1743
4371,4.000000000000000,0.000277777777778,218,739,521,438.500000000000000,210.495249352568550,1754.000000000000000,4,218,1,25.0000000,218,1,25.0000000,266,739
4372,4.000000000000000,0.000277777777778,339,1188,849,787.750000000000000,377.958579079771653,3151.000000000000000,4,339,1,25.0000000,339,1,25.0000000,489,1188
4373,4.000000000000000,0.000277777777778,572,1307,735,879.750000000000000,267.992887032473334,3519.000000000000000,4,572,1,25.0000000,572,1,25.0000000,782,1307
4374,4.000000000000000,0.000277777777778,312,1358,1046,696.250000000000000,404.375057959810363,2785.000000000000000,4,312,1,25.0000000,312,1,25.0000000,435,1358
4375,4.000000000000000,0.000277777777778,1549,3603,2054,2333.000000000000000,766.763327239898672,9332.000000000000000,4,1549,1,25.0000000,1549,1,25.0000000,2035,3603
4376,3.000000000000000,0.000208333333333,1549,3603,2054,2395.666666666666515,876.466136761078133,7187.000000000000000,3,1549,1,33.3333015,1549,1,33.3333015,2035,3603
4377,4.000000000000000,0.000277777777778,419,1538,1119,1175.750000000000000,453.331763171300395,4703.000000000000000,4,419,1,25.0000000,419,1,25.0000000,1231,1538
4378,4.000000000000000,0.000277777777778,332,838,506,663.750000000000000,197.068991726247987,2655.000000000000000,4,332,1,25.0000000,332,1,25.0000000,707,838
4379,3.000000000000000,0.000208333333333,746,1221,475,922.666666666666629,212.145128521857771,2768.000000000000000,3,746,1,33.3333015,746,1,33.3333015,801,1221
4380,4.000000000000000,0.000277777777778,1412,1709,297,1545.500000000000000,114.110691874162256,6182.000000000000000,4,1412,1,25.0000000,1412,1,25.0000000,1471,1709
4381,3.000000000000000,0.000208333333333,540,750,210,611.333333333333371,98.065737589072810,1834.000000000000000,3,540,1,33.3333015,540,1,33.3333015,544,750
4382,4.000000000000000,0.000277777777778,540,750,210,643.500000000000000,101.571403455894000,2574.000000000000000,4,540,1,25.0000000,540,1,25.0000000,544,750
4383,4.000000000000000,0.000277777777778,320,1041,721,699.000000000000000,299.755733890112595,2796.000000000000000,4,320,1,25.0000000,320,1,25.0000000,496,1041
4384,4.000000000000000,0.000277777777778,243,1146,903,660.250000000000000,322.042990142620567,2641.000000000000000,4,243,1,25.0000000,243,1,25.0000000,591,1146
4385,4.000000000000000,0.000277777777778,292,972,680,501.250000000000000,276.885693924406269,2005.000000000000000,4,292,1,25.0000000,292,1,25.0000000,311,972
4386,5.000000000000000,0.000347222222222,803,1944,1141,1402.599999999999909,426.477009931367832,7013.000000000000000,5,803,1,20.0000000,803,1,20.0000000,1427,1944
4387,4.000000000000000,0.000277777777778,469,1249,780,952.250000000000000,291.172951181939311,3809.000000000000000,4,469,1,25.0000000,469,1,25.0000000,1037,1249
4388,4.000000000000000,0.000277777777778,100,3590,3490,1319.500000000000000,1360.214413245206060,5278.000000000000000,4,100,1,25.0000000,100,1,25.0000000,473,3590
4389,4.000000000000000,0.000277777777778,706,1656,950,1072.500000000000000,353.481611968713310,4290.000000000000000,4,706,1,25.0000000,706,1,25.0000000,937,1656
4390,4.000000000000000,0.000277777777778,232,699,467,549.500000000000000,185.815096265077443,2198.000000000000000,4,232,1,25.0000000,232,1,25.0000000,613,699
4391,4.000000000000000,0.000277777777778,312,1039,727,583.000000000000000,275.975542394611466,2332.000000000000000,4,312,1,25.0000000,312,1,25.0000000,435,1039
4392,4.000000000000000,0.000277777777778,37,784,747,349.000000000000000,322.357720552804494,1396.000000000000000,4,37,1,25.0000000,37,1,25.0000000,41,784
4393,3.000000000000000,0.000208333333333,321,1166,845,790.666666666666629,351.359581562187600,2372.000000000000000,3,321,1,33.3333015,321,1,33.3333015,885,1166
4394,5.000000000000000,0.000347222222222,724,1061,337,900.200000000000045,107.754164652694527,4501.000000000000000,5,724,1,20.0000000,724,1,20.0000000,899,1061
4395,4.000000000000000,0.000277777777778,327,799,472,531.750000000000000,171.054633085456061,2127.000000000000000,4,327,1,25.0000000,327,1,25.0000000,471,799
4396,4.000000000000000,0.000277777777778,707,923,216,833.000000000000000,78.996835379653021,3332.000000000000000,4,707,1,25.0000000,707,1,25.0000000,838,923
4397,3.000000000000000,0.000208333333333,467,713,246,566.666666666666629,105.711347020501492,1700.000000000000000,3,467,1,33.3333015,467,1,33.3333015,520,713
4398,5.000000000000000,0.000347222222222,414,1852,1438,967.200000000000045,504.395638363378396,4836.000000000000000,5,414,1,20.0000000,414,1,20.0000000,809,1852
4399,4.000000000000000,0.000277777777778,1305,1846,541,1552.500000000000000,233.463594592390365,6210.000000000000000,4,1305,1,25.0000000,1305,1,25.0000000,1343,1846
4400,3.000000000000000,0.000208333333333,316,680,364,443.000000000000000,167.727954338764505,1329.000000000000000,3,316,1,33.3333015,316,1,33.3333015,333,680
4401,4.000000000000000,0.000277777777778,182,1932,1750,898.250000000000000,647.564041234533079,3593.000000000000000,4,182,1,25.0000000,182,1,25.0000000,589,1932
4402,4.000000000000000,0.000277777777778,763,1217,454,954.750000000000000,197.337749809812124,3819.000000000000000,4,763,1,25.0000000,763,1,25.0000000,765,1217
4403,5.000000000000000,0.000347222222222,375,1301,926,741.200000000000045,306.132258999276303,3706.000000000000000,5,375,1,20.0000000,375,1,20.0000000,711,1301
4404,5.000000000000000,0.000347222222222,877,2037,1160,1160.000000000000000,442.853474639185833,5800.000000000000000,5,877,1,20.0000000,877,1,20.0000000,931,2037
4405,4.000000000000000,0.000277777777778,198,684,486,404.250000000000000,203.617748489663825,1617.000000000000000,4,198,1,25.0000000,198,1,25.0000000,222,684
4406,3.000000000000000,0.000208333333333,163,1169,1006,582.666666666666742,427.272226520231015,1748.000000000000000,3,163,1,33.3333015,163,1,33.3333015,416,1169
4407,3.000000000000000,0.000208333333333,877,2037,1160,1323.333333333333258,509.902169266048759,3970.000000000000000,3,877,1,33.3333015,877,1,33.3333015,1056,2037
4408,4.000000000000000,0.000277777777778,877,2037,1160,1217.250000000000000,478.289857199585640,4869.000000000000000,4,877,1,25.0000000,877,1,25.0000000,899,2037
4409,4.000000000000000,0.000277777777778,393,615,222,506.000000000000000,81.709852527097354,2024.000000000000000,4,393,1,25.0000000,393,1,25.0000000,476,615
4410,4.000000000000000,0.000277777777778,792,1206,414,940.000000000000000,162.041661309676783,3760.000000000000000,4,792,1,25.0000000,792,1,25.0000000,829,1206
4411,3.000000000000000,0.000208333333333,402,1254,852,750.000000000000000,364.899986297615555,2250.000000000000000,3,402,1,33.3333015,402,1,33.3333015,594,1254
4412,4.000000000000000,0.000277777777778,1315,2366,1051,1774.750000000000000,469.058831597913752,7099.000000000000000,3,1315,2,50.0000000,2103,1,25.0000000,1315,2366
4413,4.000000000000000,0.000277777777778,774,871,97,846.750000000000000,42.002232083545266,3387.000000000000000,2,871,3,75.0000000,774,1,25.0000000,871,871
4414,4.000000000000000,0.000277777777778,242,1167,925,777.500000000000000,338.984144171965681,3110.000000000000000,4,242,1,25.0000000,242,1,25.0000000,778,1167
4415,4.000000000000000,0.000277777777778,1789,2391,602,2082.250000000000000,241.999354337981657,8329.000000000000000,4,1789,1,25.0000000,1789,1,25.0000000,1912,2391
4416,4.000000000000000,0.000277777777778,516,1500,984,1082.000000000000000,387.928472788476824,4328.000000000000000,4,516,1,25.0000000,516,1,25.0000000,937,1500
4417,4.000000000000000,0.000277777777778,353,1375,1022,805.500000000000000,373.774330311753772,3222.000000000000000,4,353,1,25.0000000,353,1,25.0000000,640,1375
4418,4.000000000000000,0.000277777777778,218,729,511,414.250000000000000,210.577034597792732,1657.000000000000000,4,218,1,25.0000000,218,1,25.0000000,227,729
4419,5.000000000000000,0.000347222222222,374,895,521,670.000000000000000,241.391797706550051,3350.000000000000000,5,374,1,20.0000000,374,1,20.0000000,847,895
4420,4.000000000000000,0.000277777777778,724,1333,609,1048.000000000000000,251.418973031074160,4192.000000000000000,4,724,1,25.0000000,724,1,25.0000000,886,1333
4421,4.000000000000000,0.000277777777778,378,1157,779,764.500000000000000,286.888915784489654,3058.000000000000000,4,378,1,25.0000000,378,1,25.0000000,648,1157
4422,3.000000000000000,0.000208333333333,1424,2472,1048,2052.333333333333485,452.572155081988569,6157.000000000000000,3,1424,1,33.3333015,1424,1,33.3333015,2261,2472
4423,3.000000000000000,0.000208333333333,336,861,525,668.333333333333371,235.989171126322844,2005.000000000000000,3,336,1,33.3333015,336,1,33.3333015,808,861
4424,4.000000000000000,0.000277777777778,575,937,362,804.500000000000000,139.618229468791071,3218.000000000000000,4,575,1,25.0000000,575,1,25.0000000,814,937
4425,4.000000000000000,0.000277777777778,408,1011,603,655.500000000000000,221.274151224222294,2622.000000000000000,4,408,1,25.0000000,408,1,25.0000000,567,1011
4426,4.000000000000000,0.000277777777778,249,1802,1553,761.500000000000000,623.348417821044904,3046.000000000000000,4,249,1,25.0000000,249,1,25.0000000,311,1802
4427,4.000000000000000,0.000277777777778,179,698,519,385.000000000000000,196.833686141371658,1540.000000000000000,4,179,1,25.0000000,179,1,25.0000000,265,698
4428,5.000000000000000,0.000347222222222,537,5719,5182,2689.399999999999636,1821.323321104739989,13447.000000000000000,5,537,1,20.0000000,537,1,20.0000000,2734,5719
4429,4.000000000000000,0.000277777777778,332,838,506,663.750000000000000,197.068991726247987,2655.000000000000000,4,332,1,25.0000000,332,1,25.0000000,707,838
4430,4.000000000000000,0.000277777777778,750,1577,827,1049.250000000000000,313.917485177235733,4197.000000000000000,3,935,2,50.0000000,750,1,25.0000000,935,1577
4431,4.000000000000000,0.000277777777778,759,1463,704,1143.500000000000000,268.805226883704790,4574.000000000000000,4,759,1,25.0000000,759,1,25.0000000,1040,1463
4432,3.000000000000000,0.000208333333333,1699,3320,1621,2269.333333333333485,743.841530315578893,6808.000000000000000,3,1699,1,33.3333015,1699,1,33.3333015,1789,3320
4433,4.000000000000000,0.000277777777778,257,1170,913,673.750000000000000,335.765077844614439,2695.000000000000000,4,257,1,25.0000000,257,1,25.0000000,516,1170
4434,4.000000000000000,0.000277777777778,438,877,439,632.250000000000000,158.089175783796151,2529.000000000000000,4,438,1,25.0000000,438,1,25.0000000,584,877
4435,4.000000000000000,0.000277777777778,555,935,380,772.000000000000000,150.796220111778666,3088.000000000000000,4,555,1,25.0000000,555,1,25.0000000,710,935
4436,4.000000000000000,0.000277777777778,773,1147,374,906.000000000000000,144.008680293932315,3624.000000000000000,4,773,1,25.0000000,773,1,25.0000000,826,1147
4437,4.000000000000000,0.000277777777778,773,1147,374,906.000000000000000,144.008680293932315,3624.000000000000000,4,773,1,25.0000000,773,1,25.0000000,826,1147
4438,4.000000000000000,0.000277777777778,773,951,178,857.000000000000000,65.753326912027831,3428.000000000000000,4,773,1,25.0000000,773,1,25.0000000,826,951
4439,5.000000000000000,0.000347222222222,412,789,377,597.600000000000023,143.374474715689900,2988.000000000000000,5,412,1,20.0000000,412,1,20.0000000,550,789
4440,4.000000000000000,0.000277777777778,1876,2862,986,2137.250000000000000,418.661781752287482,8549.000000000000000,4,1876,1,25.0000000,1876,1,25.0000000,1896,2862
4441,4.000000000000000,0.000277777777778,1141,1584,443,1379.000000000000000,160.201435698934972,5516.000000000000000,4,1141,1,25.0000000,1141,1,25.0000000,1354,1584
4442,5.000000000000000,0.000347222222222,305,1087,782,814.600000000000023,268.887039479406667,4073.000000000000000,5,305,1,20.0000000,305,1,20.0000000,920,1087
4443,4.000000000000000,0.000277777777778,552,1896,1344,1274.000000000000000,482.303327792790526,5096.000000000000000,4,552,1,25.0000000,552,1,25.0000000,1231,1896
4444,4.000000000000000,0.000277777777778,249,696,447,399.500000000000000,174.428352053214098,1598.000000000000000,4,249,1,25.0000000,249,1,25.0000000,311,696
4445,4.000000000000000,0.000277777777778,675,1388,713,891.000000000000000,291.249892703842875,3564.000000000000000,4,675,1,25.0000000,675,1,25.0000000,695,1388
4446,4.000000000000000,0.000277777777778,442,862,420,646.000000000000000,160.843091241122323,2584.000000000000000,4,442,1,25.0000000,442,1,25.0000000,553,862
4447,4.000000000000000,0.000277777777778,530,1440,910,1037.500000000000000,409.290544723427502,4150.000000000000000,3,1440,2,50.0000000,530,1,25.0000000,740,1440
4448,4.000000000000000,0.000277777777778,547,945,398,749.250000000000000,174.763232689258757,2997.000000000000000,4,547,1,25.0000000,547,1,25.0000000,606,945
4449,4.000000000000000,0.000277777777778,500,1011,511,745.250000000000000,187.603804598947306,2981.000000000000000,4,500,1,25.0000000,500,1,25.0000000,665,1011
4450,5.000000000000000,0.000347222222222,787,3316,2529,1734.599999999999909,953.434549405463940,8673.000000000000000,5,787,1,20.0000000,787,1,20.0000000,1492,3316
4451,4.000000000000000,0.000277777777778,336,914,578,604.250000000000000,212.958182514783886,2417.000000000000000,4,336,1,25.0000000,336,1,25.0000000,504,914
4452,4.000000000000000,0.000277777777778,619,764,145,671.750000000000000,55.305402086957109,2687.000000000000000,4,619,1,25.0000000,619,1,25.0000000,643,764
4453,4.000000000000000,0.000277777777778,206,581,375,379.750000000000000,162.724268319141629,1519.000000000000000,4,206,1,25.0000000,206,1,25.0000000,234,581
4454,4.000000000000000,0.000277777777778,205,286,81,236.500000000000000,31.100643080167973,946.000000000000000,4,205,1,25.0000000,205,1,25.0000000,216,286
4455,4.000000000000000,0.000277777777778,927,2805,1878,1847.750000000000000,669.312847254555550,7391.000000000000000,4,927,1,25.0000000,927,1,25.0000000,1713,2805
4456,4.000000000000000,0.000277777777778,548,1151,603,740.500000000000000,239.579318806945452,2962.000000000000000,4,548,1,25.0000000,548,1,25.0000000,620,1151
4457,5.000000000000000,0.000347222222222,144,1533,1389,557.799999999999955,498.299668874062149,2789.000000000000000,4,322,2,40.0000000,144,1,20.0000000,322,1533
4458,4.000000000000000,0.000277777777778,199,518,319,412.000000000000000,127.469604219986508,1648.000000000000000,4,199,1,25.0000000,199,1,25.0000000,429,518
4459,4.000000000000000,0.000277777777778,617,1368,751,871.750000000000000,295.974977827518387,3487.000000000000000,4,617,1,25.0000000,617,1,25.0000000,680,1368
4460,4.000000000000000,0.000277777777778,419,1515,1096,852.500000000000000,447.497765357549042,3410.000000000000000,4,419,1,25.0000000,419,1,25.0000000,466,1515
4461,4.000000000000000,0.000277777777778,182,1932,1750,960.000000000000000,626.566836019909374,3840.000000000000000,4,182,1,25.0000000,182,1,25.0000000,836,1932
4462,3.000000000000000,0.000208333333333,672,895,223,783.333333333333371,91.039673891233932,2350.000000000000000,3,672,1,33.3333015,672,1,33.3333015,783,895
4463,4.000000000000000,0.000277777777778,5,2253,2248,833.750000000000000,924.576490886503166,3335.000000000000000,4,5,1,25.0000000,5,1,25.0000000,17,2253
4464,4.000000000000000,0.000277777777778,501,878,377,652.250000000000000,160.161441989013070,2609.000000000000000,3,501,2,50.0000000,729,1,25.0000000,501,878
4465,3.000000000000000,0.000208333333333,501,878,377,626.666666666666629,177.719504338218940,1880.000000000000000,2,501,2,66.6667023,878,1,33.3333015,501,878
4466,4.000000000000000,0.000277777777778,537,1412,875,786.000000000000000,362.613430528986328,3144.000000000000000,4,537,1,25.0000000,537,1,25.0000000,575,1412
4467,4.000000000000000,0.000277777777778,123,1007,884,384.750000000000000,361.715616887078852,1539.000000000000000,4,123,1,25.0000000,123,1,25.0000000,168,1007
4468,3.000000000000000,0.000208333333333,654,861,207,761.333333333333371,84.681101131768997,2284.000000000000000,3,654,1,33.3333015,654,1,33.3333015,769,861
4469,3.000000000000000,0.000208333333333,268,1521,1253,818.000000000000000,522.850520384810011,2454.000000000000000,3,268,1,33.3333015,268,1,33.3333015,665,1521
4470,4.000000000000000,0.000277777777778,431,1713,1282,912.500000000000000,486.531345341695328,3650.000000000000000,4,431,1,25.0000000,431,1,25.0000000,645,1713
4471,5.000000000000000,0.000347222222222,184,987,803,711.200000000000045,283.714927347857383,3556.000000000000000,5,184,1,20.0000000,184,1,20.0000000,777,987
4472,4.000000000000000,0.000277777777778,408,796,388,641.000000000000000,145.969174828112244,2564.000000000000000,4,408,1,25.0000000,408,1,25.0000000,636,796
4473,4.000000000000000,0.000277777777778,585,3717,3132,1593.500000000000000,1248.197400253661726,6374.000000000000000,4,585,1,25.0000000,585,1,25.0000000,831,3717
4474,5.000000000000000,0.000347222222222,300,478,178,411.800000000000011,73.469449433080683,2059.000000000000000,4,478,2,40.0000000,300,1,20.0000000,454,478
4475,4.000000000000000,0.000277777777778,444,2470,2026,1378.000000000000000,880.305628744926253,5512.000000000000000,4,444,1,25.0000000,444,1,25.0000000,584,2470
4476,3.000000000000000,0.000208333333333,1402,1987,585,1608.000000000000000,268.331884054057184,4824.000000000000000,3,1402,1,33.3333015,1402,1,33.3333015,1435,1987
4477,4.000000000000000,0.000277777777778,1132,1987,855,1489.000000000000000,310.619542205573396,5956.000000000000000,4,1132,1,25.0000000,1132,1,25.0000000,1402,1987
4478,4.000000000000000,0.000277777777778,650,5108,4458,1932.250000000000227,1851.358200754246354,7729.000000000000000,4,650,1,25.0000000,650,1,25.0000000,679,5108
4479,4.000000000000000,0.000277777777778,555,1893,1338,961.999999999999886,548.879768255307454,3848.000000000000000,4,555,1,25.0000000,555,1,25.0000000,567,1893
4480,5.000000000000000,0.000347222222222,215,935,720,554.200000000000045,275.737121186103593,2771.000000000000000,5,215,1,20.0000000,215,1,20.0000000,426,935
4481,4.000000000000000,0.000277777777778,574,785,211,635.750000000000000,86.831373938225823,2543.000000000000000,4,574,1,25.0000000,574,1,25.0000000,581,785
4482,4.000000000000000,0.000277777777778,399,842,443,570.500000000000000,171.802939439347199,2282.000000000000000,4,399,1,25.0000000,399,1,25.0000000,450,842
4483,5.000000000000000,0.000347222222222,348,2099,1751,1049.200000000000045,574.860817937698698,5246.000000000000000,5,348,1,20.0000000,348,1,20.0000000,949,2099
4484,4.000000000000000,0.000277777777778,246,1211,965,769.750000000000000,344.015533806251256,3079.000000000000000,4,246,1,25.0000000,246,1,25.0000000,789,1211
4485,4.000000000000000,0.000277777777778,227,1211,984,618.250000000000000,409.925221839300832,2473.000000000000000,4,227,1,25.0000000,227,1,25.0000000,246,1211
4486,4.000000000000000,0.000277777777778,208,468,260,306.500000000000000,105.198621663974279,1226.000000000000000,4,208,1,25.0000000,208,1,25.0000000,218,468
4487,4.000000000000000,0.000277777777778,412,1878,1466,966.250000000000000,553.129449134648780,3865.000000000000000,4,412,1,25.0000000,412,1,25.0000000,684,1878
4488,4.000000000000000,0.000277777777778,724,2521,1797,1448.000000000000000,697.908661645633970,5792.000000000000000,4,724,1,25.0000000,724,1,25.0000000,948,2521
4489,4.000000000000000,0.000277777777778,409,1261,852,779.250000000000000,373.225384318912575,3117.000000000000000,4,409,1,25.0000000,409,1,25.0000000,422,1261
4490,4.000000000000000,0.000277777777778,511,1052,541,781.500000000000000,218.884101752502801,3126.000000000000000,4,511,1,25.0000000,511,1,25.0000000,631,1052
4491,4.000000000000000,0.000277777777778,1606,1946,340,1744.500000000000000,124.266849964099464,6978.000000000000000,3,1713,2,50.0000000,1606,1,25.0000000,1713,1946
4492,4.000000000000000,0.000277777777778,221,818,597,493.750000000000000,235.758748512117791,1975.000000000000000,4,221,1,25.0000000,221,1,25.0000000,324,818
4493,4.000000000000000,0.000277777777778,462,1486,1024,962.500000000000000,362.356523330269283,3850.000000000000000,4,462,1,25.0000000,462,1,25.0000000,937,1486
4494,4.000000000000000,0.000277777777778,486,911,425,722.000000000000000,159.829596758547808,2888.000000000000000,4,486,1,25.0000000,486,1,25.0000000,676,911
4495,4.000000000000000,0.000277777777778,222,854,632,611.750000000000000,235.397934357971792,2447.000000000000000,4,222,1,25.0000000,222,1,25.0000000,676,854
4496,4.000000000000000,0.000277777777778,211,366,155,294.000000000000000,65.639165137896143,1176.000000000000000,4,211,1,25.0000000,211,1,25.0000000,249,366
4497,6.000000000000000,0.000416666666667,588,1093,505,878.000000000000000,182.873362375898438,5268.000000000000000,6,588,1,16.6667004,588,1,16.6667004,778,1047
4498,4.000000000000000,0.000277777777778,458,2886,2428,1312.000000000000000,961.051507464610381,5248.000000000000000,4,458,1,25.0000000,458,1,25.0000000,614,2886
4499,4.000000000000000,0.000277777777778,561,691,130,608.000000000000000,49.360915712737736,2432.000000000000000,3,590,2,50.0000000,561,1,25.0000000,590,691
4500,4.000000000000000,0.000277777777778,539,1530,991,1050.000000000000000,470.003723389506831,4200.000000000000000,4,539,1,25.0000000,539,1,25.0000000,623,1530
4501,4.000000000000000,0.000277777777778,194,1214,1020,662.000000000000000,435.446896877219672,2648.000000000000000,4,194,1,25.0000000,194,1,25.0000000,280,1214
4502,4.000000000000000,0.000277777777778,883,1318,435,1203.500000000000000,185.197867158344991,4814.000000000000000,4,883,1,25.0000000,883,1,25.0000000,1298,1318
4503,4.000000000000000,0.000277777777778,624,1885,1261,1219.250000000000000,575.395244592793006,4877.000000000000000,4,624,1,25.0000000,624,1,25.0000000,672,1885
4504,4.000000000000000,0.000277777777778,327,1144,817,756.000000000000000,338.721862300029329,3024.000000000000000,4,327,1,25.0000000,327,1,25.0000000,528,1144
4505,4.000000000000000,0.000277777777778,198,854,656,487.500000000000000,284.673058085938294,1950.000000000000000,4,198,1,25.0000000,198,1,25.0000000,222,854
4506,4.000000000000000,0.000277777777778,724,1333,609,990.000000000000000,232.029093003442114,3960.000000000000000,4,724,1,25.0000000,724,1,25.0000000,842,1333
4507,4.000000000000000,0.000277777777778,290,2077,1787,1306.750000000000000,670.626339700432595,5227.000000000000000,4,290,1,25.0000000,290,1,25.0000000,1164,2077
4508,3.000000000000000,0.000208333333333,303,661,358,440.333333333333314,157.584545209512498,1321.000000000000000,3,303,1,33.3333015,303,1,33.3333015,357,661
4509,4.000000000000000,0.000277777777778,341,3021,2680,1233.750000000000000,1048.027045214005966,4935.000000000000000,4,341,1,25.0000000,341,1,25.0000000,754,3021
4510,4.000000000000000,0.000277777777778,341,3021,2680,1245.000000000000000,1043.747335325939957,4980.000000000000000,4,341,1,25.0000000,341,1,25.0000000,754,3021
4511,4.000000000000000,0.000277777777778,50,1037,987,408.250000000000000,380.612253481151072,1633.000000000000000,4,50,1,25.0000000,50,1,25.0000000,175,1037
4512,2.000000000000000,0.000138888888889,1499,1639,140,1569.000000000000000,70.000000000000000,3138.000000000000000,2,1499,1,50.0000000,1499,1,50.0000000,1499,1639
4513,4.000000000000000,0.000277777777778,912,2190,1278,1560.000000000000000,454.633368770925131,6240.000000000000000,4,912,1,25.0000000,912,1,25.0000000,1499,2190
4514,4.000000000000000,0.000277777777778,218,1034,816,659.000000000000000,302.524379182901555,2636.000000000000000,4,218,1,25.0000000,218,1,25.0000000,572,1034
4515,4.000000000000000,0.000277777777778,223,818,595,477.250000000000000,215.277001790716128,1909.000000000000000,4,223,1,25.0000000,223,1,25.0000000,413,818
4516,4.000000000000000,0.000277777777778,708,1634,926,1052.500000000000000,373.198003746000722,4210.000000000000000,4,708,1,25.0000000,708,1,25.0000000,744,1634
4517,4.000000000000000,0.000277777777778,714,1427,713,1117.500000000000000,316.556866929150715,4470.000000000000000,3,1427,2,50.0000000,714,1,25.0000000,902,1427
4518,4.000000000000000,0.000277777777778,57,524,467,213.000000000000000,185.589601001780267,852.000000000000000,4,57,1,25.0000000,57,1,25.0000000,87,524
4519,4.000000000000000,0.000277777777778,121,730,609,347.500000000000000,246.899270958826435,1390.000000000000000,4,121,1,25.0000000,121,1,25.0000000,139,730
4520,4.000000000000000,0.000277777777778,654,1430,776,1115.750000000000000,318.460652985576871,4463.000000000000000,4,654,1,25.0000000,654,1,25.0000000,986,1430
4521,4.000000000000000,0.000277777777778,1099,1259,160,1158.750000000000000,66.258490022034138,4635.000000000000000,3,1099,2,50.0000000,1178,1,25.0000000,1099,1259
4522,4.000000000000000,0.000277777777778,372,3183,2811,1819.750000000000000,1126.610929957631924,7279.000000000000000,4,372,1,25.0000000,372,1,25.0000000,1114,3183
4523,4.000000000000000,0.000277777777778,541,1053,512,830.500000000000000,184.440369767575561,3322.000000000000000,4,541,1,25.0000000,541,1,25.0000000,848,1053
4524,4.000000000000000,0.000277777777778,1084,2519,1435,1506.000000000000000,588.132213026968998,6024.000000000000000,4,1084,1,25.0000000,1084,1,25.0000000,1162,2519
4525,4.000000000000000,0.000277777777778,1157,1908,751,1448.250000000000000,296.590943051199758,5793.000000000000000,4,1157,1,25.0000000,1157,1,25.0000000,1220,1908
4526,4.000000000000000,0.000277777777778,218,663,445,394.750000000000000,163.872473283343112,1579.000000000000000,4,218,1,25.0000000,218,1,25.0000000,345,663
4527,4.000000000000000,0.000277777777778,336,1284,948,799.000000000000000,346.982708502887817,3196.000000000000000,4,336,1,25.0000000,336,1,25.0000000,662,1284
4528,4.000000000000000,0.000277777777778,820,2182,1362,1616.750000000000000,575.846062329160986,6467.000000000000000,4,820,1,25.0000000,820,1,25.0000000,1317,2182
4529,5.000000000000000,0.000347222222222,801,1885,1084,1160.200000000000045,385.859248949665584,5801.000000000000000,5,801,1,20.0000000,801,1,20.0000000,1011,1885
4530,4.000000000000000,0.000277777777778,217,793,576,461.500000000000000,232.741809737743523,1846.000000000000000,4,217,1,25.0000000,217,1,25.0000000,271,793
4531,4.000000000000000,0.000277777777778,114,444,330,259.500000000000000,118.367013986160856,1038.000000000000000,4,114,1,25.0000000,114,1,25.0000000,234,444
4532,4.000000000000000,0.000277777777778,368,882,514,551.750000000000000,207.244270125858975,2207.000000000000000,4,368,1,25.0000000,368,1,25.0000000,383,882
4533,4.000000000000000,0.000277777777778,1071,1752,681,1408.750000000000000,284.386510756048381,5635.000000000000000,4,1071,1,25.0000000,1071,1,25.0000000,1192,1752
4534,4.000000000000000,0.000277777777778,220,845,625,579.500000000000000,227.304311441732267,2318.000000000000000,4,220,1,25.0000000,220,1,25.0000000,591,845
4535,4.000000000000000,0.000277777777778,446,1577,1131,1176.250000000000000,436.831990014467692,4705.000000000000000,4,446,1,25.0000000,446,1,25.0000000,1254,1577
4536,4.000000000000000,0.000277777777778,409,1025,616,677.500000000000000,268.924245838860713,2710.000000000000000,4,409,1,25.0000000,409,1,25.0000000,422,1025
4537,4.000000000000000,0.000277777777778,409,1025,616,677.500000000000000,268.924245838860713,2710.000000000000000,4,409,1,25.0000000,409,1,25.0000000,422,1025
4538,4.000000000000000,0.000277777777778,736,948,212,878.500000000000000,84.132336232865882,3514.000000000000000,4,736,1,25.0000000,736,1,25.0000000,899,948
4539,4.000000000000000,0.000277777777778,1130,2805,1675,1877.500000000000000,609.396627821322909,7510.000000000000000,4,1130,1,25.0000000,1130,1,25.0000000,1629,2805
4540,4.000000000000000,0.000277777777778,1606,1946,340,1744.500000000000000,124.266849964099464,6978.000000000000000,3,1713,2,50.0000000,1606,1,25.0000000,1713,1946
4541,4.000000000000000,0.000277777777778,122,551,429,378.000000000000000,157.982593977944305,1512.000000000000000,4,122,1,25.0000000,122,1,25.0000000,398,551
4542,4.000000000000000,0.000277777777778,688,3054,2366,1517.750000000000000,911.959531722762449,6071.000000000000000,4,688,1,25.0000000,688,1,25.0000000,1045,3054
4543,3.000000000000000,0.000208333333333,688,1284,596,890.000000000000000,278.629981636339096,2670.000000000000000,3,688,1,33.3333015,688,1,33.3333015,698,1284
4544,4.000000000000000,0.000277777777778,251,504,253,374.000000000000000,119.756001937272444,1496.000000000000000,4,251,1,25.0000000,251,1,25.0000000,258,504
4545,4.000000000000000,0.000277777777778,430,1767,1337,869.250000000000000,525.680214103593585,3477.000000000000000,4,430,1,25.0000000,430,1,25.0000000,614,1767
4546,4.000000000000000,0.000277777777778,923,971,48,947.000000000000000,24.000000000000000,3788.000000000000000,2,923,2,50.0000000,923,2,50.0000000,923,971
4547,5.000000000000000,0.000347222222222,579,1639,1060,963.000000000000000,386.683850192893374,4815.000000000000000,5,579,1,20.0000000,579,1,20.0000000,860,1639
4548,4.000000000000000,0.000277777777778,770,1789,1019,1181.000000000000000,373.541831660123421,4724.000000000000000,4,770,1,25.0000000,770,1,25.0000000,1074,1789
4549,4.000000000000000,0.000277777777778,670,3401,2731,1478.500000000000000,1115.138668507195234,5914.000000000000000,4,670,1,25.0000000,670,1,25.0000000,877,3401
4550,5.000000000000000,0.000347222222222,509,4398,3889,1696.000000000000000,1395.486008528928323,8480.000000000000000,5,509,1,20.0000000,509,1,20.0000000,1078,4398
4551,4.000000000000000,0.000277777777778,316,3117,2801,1176.250000000000000,1149.452994906707772,4705.000000000000000,4,316,1,25.0000000,316,1,25.0000000,324,3117
4552,4.000000000000000,0.000277777777778,182,698,516,517.000000000000000,199.150696709803128,2068.000000000000000,4,182,1,25.0000000,182,1,25.0000000,564,698
4553,4.000000000000000,0.000277777777778,182,632,450,398.250000000000000,192.003092423012816,1593.000000000000000,4,182,1,25.0000000,182,1,25.0000000,238,632
4554,4.000000000000000,0.000277777777778,458,2097,1639,1438.500000000000000,640.004882793873662,5754.000000000000000,4,458,1,25.0000000,458,1,25.0000000,1290,2097
4555,4.000000000000000,0.000277777777778,667,1079,412,852.250000000000000,156.763157342533788,3409.000000000000000,4,667,1,25.0000000,667,1,25.0000000,755,1079
4556,4.000000000000000,0.000277777777778,513,1025,512,697.750000000000000,210.441648682004001,2791.000000000000000,3,513,2,50.0000000,740,1,25.0000000,513,1025
4557,4.000000000000000,0.000277777777778,278,1856,1578,1194.750000000000000,651.613909842323778,4779.000000000000000,4,278,1,25.0000000,278,1,25.0000000,882,1856
4558,3.000000000000000,0.000208333333333,10,105,95,63.333333333333336,39.651257511234398,190.000000000000000,3,10,1,33.3333015,10,1,33.3333015,75,105
4559,5.000000000000000,0.000347222222222,389,1413,1024,675.399999999999977,373.251979231189068,3377.000000000000000,4,504,2,40.0000000,389,1,20.0000000,504,1413
4560,4.000000000000000,0.000277777777778,502,703,201,601.750000000000000,81.701820665147977,2407.000000000000000,4,502,1,25.0000000,502,1,25.0000000,544,703
4561,4.000000000000000,0.000277777777778,502,703,201,601.750000000000000,81.701820665147977,2407.000000000000000,4,502,1,25.0000000,502,1,25.0000000,544,703
4562,4.000000000000000,0.000277777777778,507,1524,1017,941.500000000000000,414.925595739766322,3766.000000000000000,4,507,1,25.0000000,507,1,25.0000000,594,1524
4563,4.000000000000000,0.000277777777778,912,2190,1278,1560.000000000000000,454.633368770925131,6240.000000000000000,4,912,1,25.0000000,912,1,25.0000000,1499,2190
4564,4.000000000000000,0.000277777777778,17,1622,1605,694.750000000000000,676.472976178649674,2779.000000000000000,4,17,1,25.0000000,17,1,25.0000000,80,1622
4565,4.000000000000000,0.000277777777778,300,1286,986,750.250000000000000,354.348962888280539,3001.000000000000000,4,300,1,25.0000000,300,1,25.0000000,641,1286
4566,5.000000000000000,0.000347222222222,222,684,462,486.000000000000000,175.390991786921603,2430.000000000000000,5,222,1,20.0000000,222,1,20.0000000,453,684
4567,4.000000000000000,0.000277777777778,466,621,155,517.250000000000000,61.352974663010428,2069.000000000000000,4,466,1,25.0000000,466,1,25.0000000,479,621
4568,4.000000000000000,0.000277777777778,223,818,595,477.250000000000000,215.277001790716128,1909.000000000000000,4,223,1,25.0000000,223,1,25.0000000,413,818
4569,5.000000000000000,0.000347222222222,272,1696,1424,936.000000000000000,573.422008646337190,4680.000000000000000,5,272,1,20.0000000,272,1,20.0000000,796,1696
4570,4.000000000000000,0.000277777777778,272,1508,1236,746.000000000000000,480.120818128104077,2984.000000000000000,4,272,1,25.0000000,272,1,25.0000000,408,1508
4571,4.000000000000000,0.000277777777778,38,1938,1900,647.250000000000000,756.446751265414605,2589.000000000000000,4,38,1,25.0000000,38,1,25.0000000,208,1938
4572,4.000000000000000,0.000277777777778,302,899,597,463.000000000000057,252.145791160590306,1852.000000000000000,4,302,1,25.0000000,302,1,25.0000000,310,899
4573,4.000000000000000,0.000277777777778,414,1151,737,707.000000000000000,271.408363909441846,2828.000000000000000,4,414,1,25.0000000,414,1,25.0000000,620,1151
4574,4.000000000000000,0.000277777777778,222,854,632,611.500000000000000,235.330087324166868,2446.000000000000000,4,222,1,25.0000000,222,1,25.0000000,675,854
4575,4.000000000000000,0.000277777777778,356,1763,1407,978.000000000000000,504.185977591602580,3912.000000000000000,4,356,1,25.0000000,356,1,25.0000000,882,1763
4576,4.000000000000000,0.000277777777778,280,911,631,536.000000000000000,248.647340625231692,2144.000000000000000,4,280,1,25.0000000,280,1,25.0000000,346,911
4577,5.000000000000000,0.000347222222222,280,960,680,613.200000000000045,280.473456854654955,3066.000000000000000,5,280,1,20.0000000,280,1,20.0000000,569,960
4578,4.000000000000000,0.000277777777778,476,1281,805,945.750000000000000,306.767318174540890,3783.000000000000000,4,476,1,25.0000000,476,1,25.0000000,882,1281
4579,4.000000000000000,0.000277777777778,548,662,114,618.250000000000000,43.199392356837599,2473.000000000000000,4,548,1,25.0000000,548,1,25.0000000,620,662
4580,4.000000000000000,0.000277777777778,462,1440,978,860.250000000000000,382.523446993775792,3441.000000000000000,4,462,1,25.0000000,462,1,25.0000000,577,1440
4581,4.000000000000000,0.000277777777778,899,948,49,923.500000000000000,24.499999999999996,3694.000000000000000,2,899,2,50.0000000,899,2,50.0000000,899,948
4582,4.000000000000000,0.000277777777778,182,632,450,398.250000000000000,192.003092423012816,1593.000000000000000,4,182,1,25.0000000,182,1,25.0000000,238,632
4583,4.000000000000000,0.000277777777778,931,7939,7008,3688.000000000000000,2836.967571192874857,14752.000000000000000,4,931,1,25.0000000,931,1,25.0000000,1297,7939
4584,4.000000000000000,0.000277777777778,1124,2241,1117,1695.750000000000000,483.481837818133556,6783.000000000000000,4,1124,1,25.0000000,1124,1,25.0000000,1315,2241
4585,4.000000000000000,0.000277777777778,108,1042,934,481.500000000000000,343.323826729226596,1926.000000000000000,4,108,1,25.0000000,108,1,25.0000000,375,1042
4586,4.000000000000000,0.000277777777778,108,401,293,266.000000000000000,124.965995374741851,1064.000000000000000,4,108,1,25.0000000,108,1,25.0000000,180,401
4587,4.000000000000000,0.000277777777778,647,1483,836,1017.500000000000000,306.962945646538913,4070.000000000000000,4,647,1,25.0000000,647,1,25.0000000,874,1483
4588,4.000000000000000,0.000277777777778,614,715,101,663.250000000000000,36.567574434189645,2653.000000000000000,4,614,1,25.0000000,614,1,25.0000000,651,715
4589,4.000000000000000,0.000277777777778,707,923,216,833.000000000000000,78.996835379653021,3332.000000000000000,4,707,1,25.0000000,707,1,25.0000000,838,923
4590,4.000000000000000,0.000277777777778,138,398,260,263.250000000000000,92.079788770391957,1053.000000000000000,4,138,1,25.0000000,138,1,25.0000000,255,398
4591,3.000000000000000,0.000208333333333,725,1305,580,1104.666666666666742,268.601729124905091,3314.000000000000000,3,725,1,33.3333015,725,1,33.3333015,1284,1305
4592,4.000000000000000,0.000277777777778,194,4670,4476,1759.500000000000000,1721.813796552925851,7038.000000000000000,4,194,1,25.0000000,194,1,25.0000000,960,4670
4593,5.000000000000000,0.000347222222222,383,1600,1217,986.200000000000045,454.446212438831992,4931.000000000000000,5,383,1,20.0000000,383,1,20.0000000,882,1600
4594,6.000000000000000,0.000416666666667,383,1600,1217,927.166666666666742,435.345616212631171,5563.000000000000000,6,383,1,16.6667004,383,1,16.6667004,661,1405
4595,4.000000000000000,0.000277777777778,1606,1946,340,1744.500000000000000,124.266849964099464,6978.000000000000000,3,1713,2,50.0000000,1606,1,25.0000000,1713,1946
4596,3.000000000000000,0.000208333333333,1606,1946,340,1755.000000000000000,141.945999121731745,5265.000000000000000,3,1606,1,33.3333015,1606,1,33.3333015,1713,1946
4597,4.000000000000000,0.000277777777778,60,1266,1206,502.999999999999943,463.254249845589641,2012.000000000000000,4,60,1,25.0000000,60,1,25.0000000,223,1266
4598,4.000000000000000,0.000277777777778,1001,1577,576,1315.000000000000000,214.318687939246217,5260.000000000000000,4,1001,1,25.0000000,1001,1,25.0000000,1254,1577
4599,4.000000000000000,0.000277777777778,1001,1577,576,1315.000000000000000,214.318687939246217,5260.000000000000000,4,1001,1,25.0000000,1001,1,25.0000000,1254,1577
4600,5.000000000000000,0.000347222222222,600,1231,631,921.399999999999977,224.895175581869665,4607.000000000000000,5,600,1,20.0000000,600,1,20.0000000,913,1231
4601,4.000000000000000,0.000277777777778,824,1888,1064,1261.750000000000000,453.145878829323578,5047.000000000000000,4,824,1,25.0000000,824,1,25.0000000,836,1888
4602,3.000000000000000,0.000208333333333,781,8721,7940,3807.666666666666515,3505.284898866599178,11423.000000000000000,3,781,1,33.3333015,781,1,33.3333015,1921,8721
4603,5.000000000000000,0.000347222222222,81,695,614,400.600000000000023,216.692962506861306,2003.000000000000000,5,81,1,20.0000000,81,1,20.0000000,445,695
4604,4.000000000000000,0.000277777777778,958,1438,480,1210.750000000000000,227.964224166863517,4843.000000000000000,3,1438,2,50.0000000,958,1,25.0000000,1009,1438
4605,5.000000000000000,0.000347222222222,257,1500,1243,765.799999999999955,482.159890492770046,3829.000000000000000,5,257,1,20.0000000,257,1,20.0000000,489,1500
4606,4.000000000000000,0.000277777777778,899,3117,2218,1708.750000000000000,849.968344998800490,6835.000000000000000,4,899,1,25.0000000,899,1,25.0000000,1220,3117
4607,4.000000000000000,0.000277777777778,655,877,222,758.250000000000000,93.304273749919943,3033.000000000000000,4,655,1,25.0000000,655,1,25.0000000,680,877
4608,4.000000000000000,0.000277777777778,502,709,207,602.500000000000000,83.097833906787244,2410.000000000000000,4,502,1,25.0000000,502,1,25.0000000,544,709
4609,4.000000000000000,0.000277777777778,471,565,94,517.250000000000000,33.469202261183341,2069.000000000000000,4,471,1,25.0000000,471,1,25.0000000,511,565
4610,4.000000000000000,0.000277777777778,359,2042,1683,1564.250000000000000,702.049277116642315,6257.000000000000000,3,2042,2,50.0000000,359,1,25.0000000,1814,2042
4611,4.000000000000000,0.000277777777778,308,1968,1660,1184.500000000000000,589.257795875455486,4738.000000000000000,4,308,1,25.0000000,308,1,25.0000000,1196,1968
4612,4.000000000000000,0.000277777777778,55,589,534,405.000000000000000,212.093139917348594,1620.000000000000000,4,55,1,25.0000000,55,1,25.0000000,418,589
4613,5.000000000000000,0.000347222222222,698,3079,2381,1455.400000000000091,836.171657017863822,7277.000000000000000,5,698,1,20.0000000,698,1,20.0000000,1234,3079
4614,4.000000000000000,0.000277777777778,242,705,463,540.000000000000000,179.720616513520810,2160.000000000000000,4,242,1,25.0000000,242,1,25.0000000,560,705
4615,4.000000000000000,0.000277777777778,302,504,202,380.000000000000000,76.485292703891773,1520.000000000000000,4,302,1,25.0000000,302,1,25.0000000,336,504
4616,4.000000000000000,0.000277777777778,245,361,116,300.500000000000000,54.205627014176308,1202.000000000000000,4,245,1,25.0000000,245,1,25.0000000,248,361
4617,4.000000000000000,0.000277777777778,1547,4839,3292,2896.000000000000000,1214.547240744467672,11584.000000000000000,4,1547,1,25.0000000,1547,1,25.0000000,2345,4839
4618,4.000000000000000,0.000277777777778,698,7639,6941,3162.500000000000000,2731.249576659005925,12650.000000000000000,4,698,1,25.0000000,698,1,25.0000000,1234,7639
4619,4.000000000000000,0.000277777777778,407,1027,620,728.000000000000000,240.481808043768666,2912.000000000000000,4,407,1,25.0000000,407,1,25.0000000,600,1027
4620,4.000000000000000,0.000277777777778,1001,1428,427,1147.250000000000000,168.717774700829892,4589.000000000000000,4,1001,1,25.0000000,1001,1,25.0000000,1032,1428
4621,4.000000000000000,0.000277777777778,274,777,503,520.750000000000000,178.922294586225348,2083.000000000000000,4,274,1,25.0000000,274,1,25.0000000,489,777
4622,4.000000000000000,0.000277777777778,274,777,503,520.750000000000000,178.922294586225348,2083.000000000000000,4,274,1,25.0000000,274,1,25.0000000,489,777
4623,4.000000000000000,0.000277777777778,773,3717,2944,1759.250000000000000,1148.857339925197039,7037.000000000000000,4,773,1,25.0000000,773,1,25.0000000,1241,3717
4624,4.000000000000000,0.000277777777778,735,1306,571,1013.750000000000000,261.110489065452896,4055.000000000000000,4,735,1,25.0000000,735,1,25.0000000,773,1306
4625,5.000000000000000,0.000347222222222,274,1381,1107,944.399999999999977,378.968389183055706,4722.000000000000000,5,274,1,20.0000000,274,1,20.0000000,948,1381
4626,4.000000000000000,0.000277777777778,255,1211,956,607.500000000000000,393.235616393022099,2430.000000000000000,4,255,1,25.0000000,255,1,25.0000000,260,1211
4627,5.000000000000000,0.000347222222222,511,1494,983,1051.400000000000091,330.343215459315900,5257.000000000000000,5,511,1,20.0000000,511,1,20.0000000,1062,1494
4628,4.000000000000000,0.000277777777778,262,1192,930,710.500000000000000,330.891598563638354,2842.000000000000000,4,262,1,25.0000000,262,1,25.0000000,647,1192
4629,4.000000000000000,0.000277777777778,470,1339,869,859.000000000000000,317.845088053913457,3436.000000000000000,4,470,1,25.0000000,470,1,25.0000000,718,1339
4630,3.000000000000000,0.000208333333333,486,1382,896,910.333333333333371,367.318511497703980,2731.000000000000000,3,486,1,33.3333015,486,1,33.3333015,863,1382
4631,4.000000000000000,0.000277777777778,175,2862,2687,1012.250000000000114,1091.818294177195185,4049.000000000000000,4,175,1,25.0000000,175,1,25.0000000,248,2862
4632,4.000000000000000,0.000277777777778,171,894,723,420.750000000000000,279.180385235066240,1683.000000000000000,4,171,1,25.0000000,171,1,25.0000000,294,894
4633,5.000000000000000,0.000347222222222,192,1224,1032,496.000000000000000,383.805679999658139,2480.000000000000000,5,192,1,20.0000000,192,1,20.0000000,338,1224
4634,4.000000000000000,0.000277777777778,249,709,460,543.250000000000000,174.909083526270877,2173.000000000000000,4,249,1,25.0000000,249,1,25.0000000,602,709
4635,4.000000000000000,0.000277777777778,506,973,467,669.250000000000000,181.648527381864568,2677.000000000000000,4,506,1,25.0000000,506,1,25.0000000,559,973
4636,4.000000000000000,0.000277777777778,489,1500,1011,918.750000000000000,432.397603485495722,3675.000000000000000,4,489,1,25.0000000,489,1,25.0000000,516,1500
4637,4.000000000000000,0.000277777777778,489,1500,1011,918.750000000000000,432.397603485495722,3675.000000000000000,4,489,1,25.0000000,489,1,25.0000000,516,1500
4638,4.000000000000000,0.000277777777778,489,1500,1011,918.750000000000000,432.397603485495722,3675.000000000000000,4,489,1,25.0000000,489,1,25.0000000,516,1500
4639,4.000000000000000,0.000277777777778,565,813,248,641.500000000000000,101.807416232806943,2566.000000000000000,3,565,2,50.0000000,623,1,25.0000000,565,813
4640,4.000000000000000,0.000277777777778,382,937,555,646.750000000000000,213.606384501961941,2587.000000000000000,4,382,1,25.0000000,382,1,25.0000000,516,937
4641,4.000000000000000,0.000277777777778,440,676,236,570.500000000000000,93.200053648053228,2282.000000000000000,4,440,1,25.0000000,440,1,25.0000000,527,676
4642,4.000000000000000,0.000277777777778,123,266,143,168.750000000000000,56.808340056720539,675.000000000000000,4,123,1,25.0000000,123,1,25.0000000,139,266
4643,3.000000000000000,0.000208333333333,1194,1747,553,1545.000000000000000,249.135839787587884,4635.000000000000000,3,1194,1,33.3333015,1194,1,33.3333015,1694,1747
4644,4.000000000000000,0.000277777777778,238,966,728,569.250000000000000,324.454445955052392,2277.000000000000000,4,238,1,25.0000000,238,1,25.0000000,261,966
4645,4.000000000000000,0.000277777777778,677,2349,1672,1388.750000000000000,618.741616104816444,5555.000000000000000,4,677,1,25.0000000,677,1,25.0000000,1075,2349
4646,4.000000000000000,0.000277777777778,1001,1428,427,1147.250000000000000,168.717774700829892,4589.000000000000000,4,1001,1,25.0000000,1001,1,25.0000000,1032,1428
4647,4.000000000000000,0.000277777777778,1032,1428,396,1169.000000000000000,153.372096549535371,4676.000000000000000,4,1032,1,25.0000000,1032,1,25.0000000,1088,1428
4648,3.000000000000000,0.000208333333333,98,592,494,371.333333333333314,205.084264524501123,1114.000000000000000,3,98,1,33.3333015,98,1,33.3333015,424,592
4649,4.000000000000000,0.000277777777778,12,1440,1428,491.250000000000000,573.856852795189639,1965.000000000000000,4,12,1,25.0000000,12,1,25.0000000,60,1440
4650,4.000000000000000,0.000277777777778,249,470,221,358.750000000000000,78.343394743909329,1435.000000000000000,4,249,1,25.0000000,249,1,25.0000000,350,470
4651,4.000000000000000,0.000277777777778,410,939,529,707.750000000000000,192.493344040774559,2831.000000000000000,4,410,1,25.0000000,410,1,25.0000000,697,939
4652,4.000000000000000,0.000277777777778,948,1587,639,1237.750000000000000,276.707765521678141,4951.000000000000000,4,948,1,25.0000000,948,1,25.0000000,986,1587
4653,4.000000000000000,0.000277777777778,710,1183,473,910.750000000000000,171.849316262823692,3643.000000000000000,4,710,1,25.0000000,710,1,25.0000000,851,1183
4654,4.000000000000000,0.000277777777778,850,1734,884,1116.000000000000000,360.568994784632025,4464.000000000000000,4,850,1,25.0000000,850,1,25.0000000,888,1734
4655,4.000000000000000,0.000277777777778,462,1801,1339,1207.750000000000000,492.838398970697142,4831.000000000000000,4,462,1,25.0000000,462,1,25.0000000,1123,1801
4656,4.000000000000000,0.000277777777778,413,1014,601,673.500000000000000,216.252745647309666,2694.000000000000000,4,413,1,25.0000000,413,1,25.0000000,628,1014
4657,4.000000000000000,0.000277777777778,518,1686,1168,963.250000000000000,482.546047025566281,3853.000000000000000,4,518,1,25.0000000,518,1,25.0000000,531,1686
4658,6.000000000000000,0.000416666666667,1279,16313,15034,4242.500000000000000,5418.207414203828193,25455.000000000000000,6,1279,1,16.6667004,1279,1,16.6667004,1783,2560
4659,4.000000000000000,0.000277777777778,1279,2238,959,1645.500000000000000,398.878740972742264,6582.000000000000000,4,1279,1,25.0000000,1279,1,25.0000000,1282,2238
4660,4.000000000000000,0.000277777777778,234,697,463,519.000000000000000,173.561228389292069,2076.000000000000000,4,234,1,25.0000000,234,1,25.0000000,542,697
4661,4.000000000000000,0.000277777777778,744,1634,890,1092.500000000000000,341.345499457660935,4370.000000000000000,4,744,1,25.0000000,744,1,25.0000000,868,1634
4662,4.000000000000000,0.000277777777778,735,1306,571,1013.750000000000000,261.110489065452896,4055.000000000000000,4,735,1,25.0000000,735,1,25.0000000,773,1306
4663,4.000000000000000,0.000277777777778,735,1306,571,934.750000000000000,219.340346265797621,3739.000000000000000,4,735,1,25.0000000,735,1,25.0000000,847,1306
4664,4.000000000000000,0.000277777777778,501,729,228,571.500000000000000,91.598307844632146,2286.000000000000000,3,528,2,50.0000000,501,1,25.0000000,528,729
4665,4.000000000000000,0.000277777777778,227,1636,1409,727.500000000000000,553.891911838401938,2910.000000000000000,4,227,1,25.0000000,227,1,25.0000000,339,1636
4666,4.000000000000000,0.000277777777778,366,1884,1518,1188.250000000000000,549.084863659525809,4753.000000000000000,4,366,1,25.0000000,366,1,25.0000000,1114,1884
4667,3.000000000000000,0.000208333333333,57,4036,3979,1539.000000000000000,1775.908969138527254,4617.000000000000000,3,57,1,33.3333015,57,1,33.3333015,524,4036
4668,4.000000000000000,0.000277777777778,324,1027,703,670.750000000000000,249.893352252515939,2683.000000000000000,4,324,1,25.0000000,324,1,25.0000000,630,1027
4669,4.000000000000000,0.000277777777778,412,696,284,542.500000000000000,101.954646779830497,2170.000000000000000,4,412,1,25.0000000,412,1,25.0000000,512,696
4670,5.000000000000000,0.000347222222222,1118,5216,4098,2454.199999999999818,1484.419132186054867,12271.000000000000000,5,1118,1,20.0000000,1118,1,20.0000000,2358,5216
4671,4.000000000000000,0.000277777777778,324,1113,789,670.000000000000000,341.295326660064347,2680.000000000000000,4,324,1,25.0000000,324,1,25.0000000,352,1113
4672,4.000000000000000,0.000277777777778,440,676,236,570.500000000000000,93.200053648053228,2282.000000000000000,4,440,1,25.0000000,440,1,25.0000000,527,676
4673,4.000000000000000,0.000277777777778,39,632,593,235.500000000000000,234.802576646850270,942.000000000000000,4,39,1,25.0000000,39,1,25.0000000,87,632
4674,4.000000000000000,0.000277777777778,251,616,365,411.500000000000000,132.673471349776634,1646.000000000000000,4,251,1,25.0000000,251,1,25.0000000,359,616
4675,4.000000000000000,0.000277777777778,286,697,411,410.500000000000000,166.364809980957205,1642.000000000000000,4,286,1,25.0000000,286,1,25.0000000,328,697
4676,4.000000000000000,0.000277777777778,139,1604,1465,784.750000000000000,580.865033807338023,3139.000000000000000,4,139,1,25.0000000,139,1,25.0000000,347,1604
4677,5.000000000000000,0.000347222222222,340,813,473,565.000000000000000,163.079121900996256,2825.000000000000000,5,340,1,20.0000000,340,1,20.0000000,613,813
4678,4.000000000000000,0.000277777777778,431,751,320,561.750000000000000,125.700785598181511,2247.000000000000000,4,431,1,25.0000000,431,1,25.0000000,467,751
4679,4.000000000000000,0.000277777777778,143,1266,1123,629.750000000000000,416.306002238737847,2519.000000000000000,4,143,1,25.0000000,143,1,25.0000000,413,1266
4680,5.000000000000000,0.000347222222222,283,1108,825,706.600000000000023,281.786160057586926,3533.000000000000000,5,283,1,20.0000000,283,1,20.0000000,703,1108
4681,4.000000000000000,0.000277777777778,440,3167,2727,1504.250000000000000,1052.291160991101378,6017.000000000000000,4,440,1,25.0000000,440,1,25.0000000,785,3167
4682,4.000000000000000,0.000277777777778,281,1071,790,576.750000000000000,323.008030085940788,2307.000000000000000,4,281,1,25.0000000,281,1,25.0000000,296,1071
4683,4.000000000000000,0.000277777777778,0,554,554,212.750000000000000,218.274339994420785,851.000000000000000,4,0,1,25.0000000,0,1,25.0000000,47,554
4684,5.000000000000000,0.000347222222222,850,1634,784,1072.200000000000045,289.764318024148736,5361.000000000000000,5,850,1,20.0000000,850,1,20.0000000,960,1634
4685,4.000000000000000,0.000277777777778,457,763,306,604.500000000000000,128.977711252758695,2418.000000000000000,4,457,1,25.0000000,457,1,25.0000000,500,763
4686,4.000000000000000,0.000277777777778,470,935,465,696.250000000000000,177.440659094808382,2785.000000000000000,4,470,1,25.0000000,470,1,25.0000000,596,935
4687,4.000000000000000,0.000277777777778,470,935,465,696.250000000000000,177.440659094808382,2785.000000000000000,4,470,1,25.0000000,470,1,25.0000000,596,935
4688,4.000000000000000,0.000277777777778,0,341,341,147.250000000000000,150.876398087971324,589.000000000000000,3,0,2,50.0000000,248,1,25.0000000,0,341
4689,4.000000000000000,0.000277777777778,0,778,778,341.750000000000000,281.023464322821269,1367.000000000000000,4,0,1,25.0000000,0,1,25.0000000,248,778
4690,4.000000000000000,0.000277777777778,230,785,555,495.250000000000000,248.095117847973796,1981.000000000000000,4,230,1,25.0000000,230,1,25.0000000,269,785
4691,4.000000000000000,0.000277777777778,230,785,555,495.250000000000000,248.095117847973796,1981.000000000000000,4,230,1,25.0000000,230,1,25.0000000,269,785
4692,4.000000000000000,0.000277777777778,23,109,86,78.000000000000000,33.771289581536564,312.000000000000000,4,23,1,25.0000000,23,1,25.0000000,78,109
4693,3.000000000000000,0.000208333333333,23,102,79,67.666666666666657,33.068951533962419,203.000000000000000,3,23,1,33.3333015,23,1,33.3333015,78,102
4694,3.000000000000000,0.000208333333333,188,520,332,373.666666666666629,138.362647496433169,1121.000000000000000,3,188,1,33.3333015,188,1,33.3333015,413,520
4695,4.000000000000000,0.000277777777778,824,1888,1064,1261.750000000000000,453.145878829323578,5047.000000000000000,4,824,1,25.0000000,824,1,25.0000000,836,1888
4696,4.000000000000000,0.000277777777778,56,251,195,127.750000000000000,77.872893229929502,511.000000000000000,4,56,1,25.0000000,56,1,25.0000000,66,251
4697,4.000000000000000,0.000277777777778,108,919,811,538.250000000000000,349.324616223935777,2153.000000000000000,4,108,1,25.0000000,108,1,25.0000000,283,919
4698,4.000000000000000,0.000277777777778,108,612,504,253.500000000000000,208.898898991832880,1014.000000000000000,4,108,1,25.0000000,108,1,25.0000000,114,612
4699,4.000000000000000,0.000277777777778,141,649,508,294.250000000000000,205.940980623090184,1177.000000000000000,4,141,1,25.0000000,141,1,25.0000000,191,649
4700,4.000000000000000,0.000277777777778,383,1097,714,721.250000000000000,275.143939602528746,2885.000000000000000,4,383,1,25.0000000,383,1,25.0000000,550,1097
4701,5.000000000000000,0.000347222222222,371,1124,753,789.600000000000023,283.711543649531450,3948.000000000000000,5,371,1,20.0000000,371,1,20.0000000,780,1124
4702,4.000000000000000,0.000277777777778,559,1198,639,807.250000000000000,237.311372462425396,3229.000000000000000,4,559,1,25.0000000,559,1,25.0000000,716,1198
4703,4.000000000000000,0.000277777777778,237,283,46,257.000000000000000,16.911534525287770,1028.000000000000000,4,237,1,25.0000000,237,1,25.0000000,249,283
4704,5.000000000000000,0.000347222222222,170,283,113,239.600000000000023,37.945223678349826,1198.000000000000000,5,170,1,20.0000000,170,1,20.0000000,249,283
4705,4.000000000000000,0.000277777777778,1225,3824,2599,2284.750000000000000,1087.006065990434308,9139.000000000000000,4,1225,1,25.0000000,1225,1,25.0000000,1297,3824
4706,4.000000000000000,0.000277777777778,987,2793,1806,1575.500000000000000,712.223806117150275,6302.000000000000000,4,987,1,25.0000000,987,1,25.0000000,1225,2793
4707,4.000000000000000,0.000277777777778,0,731,731,348.000000000000000,267.519158192455450,1392.000000000000000,4,0,1,25.0000000,0,1,25.0000000,236,731
4708,4.000000000000000,0.000277777777778,804,858,54,844.500000000000000,23.382685902179844,3378.000000000000000,2,858,3,75.0000000,804,1,25.0000000,858,858
4709,4.000000000000000,0.000277777777778,651,869,218,774.000000000000000,81.538334542716768,3096.000000000000000,4,651,1,25.0000000,651,1,25.0000000,756,869
4710,4.000000000000000,0.000277777777778,651,869,218,774.000000000000000,81.538334542716768,3096.000000000000000,4,651,1,25.0000000,651,1,25.0000000,756,869
4711,4.000000000000000,0.000277777777778,747,2743,1996,1602.750000000000000,726.806843322213126,6411.000000000000000,4,747,1,25.0000000,747,1,25.0000000,1319,2743
4712,4.000000000000000,0.000277777777778,155,751,596,433.250000000000000,212.002800689047490,1733.000000000000000,4,155,1,25.0000000,155,1,25.0000000,396,751
4713,4.000000000000000,0.000277777777778,47,389,342,188.000000000000000,135.124017110208797,752.000000000000000,4,47,1,25.0000000,47,1,25.0000000,84,389
4714,4.000000000000000,0.000277777777778,47,389,342,188.000000000000000,135.124017110208797,752.000000000000000,4,47,1,25.0000000,47,1,25.0000000,84,389
4715,4.000000000000000,0.000277777777778,148,2059,1911,773.750000000000000,751.814596493044974,3095.000000000000000,3,444,2,50.0000000,148,1,25.0000000,444,2059
4716,4.000000000000000,0.000277777777778,52,340,288,248.500000000000000,114.596029599633169,994.000000000000000,4,52,1,25.0000000,52,1,25.0000000,297,340
4717,4.000000000000000,0.000277777777778,208,485,277,357.250000000000000,123.792921849352922,1429.000000000000000,4,208,1,25.0000000,208,1,25.0000000,262,485
4718,4.000000000000000,0.000277777777778,196,1189,993,529.250000000000000,393.455445381049458,2117.000000000000000,4,196,1,25.0000000,196,1,25.0000000,267,1189
4719,4.000000000000000,0.000277777777778,407,3987,3580,1468.000000000000000,1463.950648075268873,5872.000000000000000,4,407,1,25.0000000,407,1,25.0000000,600,3987
4720,4.000000000000000,0.000277777777778,430,632,202,524.000000000000000,75.458597919653926,2096.000000000000000,4,430,1,25.0000000,430,1,25.0000000,484,632
4721,4.000000000000000,0.000277777777778,430,632,202,524.000000000000000,75.458597919653926,2096.000000000000000,4,430,1,25.0000000,430,1,25.0000000,484,632
4722,4.000000000000000,0.000277777777778,430,632,202,524.000000000000000,75.458597919653926,2096.000000000000000,4,430,1,25.0000000,430,1,25.0000000,484,632
4723,4.000000000000000,0.000277777777778,370,1297,927,746.750000000000000,339.066641679773625,2987.000000000000000,4,370,1,25.0000000,370,1,25.0000000,653,1297
4724,5.000000000000000,0.000347222222222,479,697,218,570.000000000000000,84.479583332305808,2850.000000000000000,5,479,1,20.0000000,479,1,20.0000000,517,697
4725,4.000000000000000,0.000277777777778,257,2017,1760,904.750000000000000,670.563335934794509,3619.000000000000000,4,257,1,25.0000000,257,1,25.0000000,542,2017
4726,4.000000000000000,0.000277777777778,395,1989,1594,829.250000000000000,670.520833009683656,3317.000000000000000,4,395,1,25.0000000,395,1,25.0000000,438,1989
4727,4.000000000000000,0.000277777777778,138,1018,880,391.500000000000000,364.974999143776984,1566.000000000000000,4,138,1,25.0000000,138,1,25.0000000,148,1018
4728,4.000000000000000,0.000277777777778,0,798,798,251.000000000000000,326.816462253663076,1004.000000000000000,3,0,2,50.0000000,206,1,25.0000000,0,798
4729,3.000000000000000,0.000208333333333,427,750,323,547.666666666666629,143.954468110194085,1643.000000000000000,3,427,1,33.3333015,427,1,33.3333015,466,750
4730,4.000000000000000,0.000277777777778,255,2061,1806,1028.250000000000000,745.909302462437495,4113.000000000000000,4,255,1,25.0000000,255,1,25.0000000,385,2061
4731,4.000000000000000,0.000277777777778,713,858,145,796.000000000000000,59.653164207776939,3184.000000000000000,4,713,1,25.0000000,713,1,25.0000000,766,858
4732,4.000000000000000,0.000277777777778,0,516,516,268.250000000000000,182.738029703726426,1073.000000000000000,4,0,1,25.0000000,0,1,25.0000000,275,516
4733,4.000000000000000,0.000277777777778,0,516,516,197.750000000000000,215.325770636029546,791.000000000000000,3,0,2,50.0000000,275,1,25.0000000,0,516
4734,4.000000000000000,0.000277777777778,92,822,730,430.750000000000000,260.207008937115290,1723.000000000000000,4,92,1,25.0000000,92,1,25.0000000,376,822
4735,4.000000000000000,0.000277777777778,444,758,314,536.000000000000000,129.141395377315007,2144.000000000000000,4,444,1,25.0000000,444,1,25.0000000,455,758
4736,4.000000000000000,0.000277777777778,35,389,354,175.750000000000000,145.796733502503400,703.000000000000000,4,35,1,25.0000000,35,1,25.0000000,47,389
4737,4.000000000000000,0.000277777777778,448,619,171,518.500000000000000,66.642704026772506,2074.000000000000000,4,448,1,25.0000000,448,1,25.0000000,470,619
4738,4.000000000000000,0.000277777777778,114,1079,965,602.250000000000000,384.299606427068852,2409.000000000000000,4,114,1,25.0000000,114,1,25.0000000,358,1079
4739,4.000000000000000,0.000277777777778,0,612,612,241.250000000000000,257.362948965075418,965.000000000000000,4,0,1,25.0000000,0,1,25.0000000,2,612
4740,4.000000000000000,0.000277777777778,444,656,212,548.750000000000000,104.764915405874305,2195.000000000000000,3,444,2,50.0000000,651,1,25.0000000,444,656
4741,4.000000000000000,0.000277777777778,10,2967,2957,1057.000000000000000,1131.025419696657309,4228.000000000000000,4,10,1,25.0000000,10,1,25.0000000,616,2967
4742,4.000000000000000,0.000277777777778,0,148,148,41.000000000000000,62.120849961989414,164.000000000000000,3,0,2,50.0000000,16,1,25.0000000,0,148
4743,3.000000000000000,0.000208333333333,211,2947,2736,1339.000000000000000,1167.397104673469812,4017.000000000000000,3,211,1,33.3333015,211,1,33.3333015,859,2947
4744,5.000000000000000,0.000347222222222,145,1030,885,704.200000000000045,317.754874077487614,3521.000000000000000,5,145,1,20.0000000,145,1,20.0000000,858,1030
4745,3.000000000000000,0.000208333333333,281,751,470,487.666666666666686,196.015872373188756,1463.000000000000000,3,281,1,33.3333015,281,1,33.3333015,431,751
4746,4.000000000000000,0.000277777777778,0,384,384,120.250000000000000,157.340991162506668,481.000000000000000,3,0,2,50.0000000,97,1,25.0000000,0,384
4747,5.000000000000000,0.000347222222222,435,2128,1693,934.000000000000114,630.659337519076189,4670.000000000000000,5,435,1,20.0000000,435,1,20.0000000,651,2128
4748,4.000000000000000,0.000277777777778,246,948,702,558.500000000000000,256.555549540445554,2234.000000000000000,4,246,1,25.0000000,246,1,25.0000000,446,948
4749,4.000000000000000,0.000277777777778,73,643,570,435.750000000000000,216.941668427252608,1743.000000000000000,4,73,1,25.0000000,73,1,25.0000000,485,643
4750,4.000000000000000,0.000277777777778,621,858,237,796.750000000000000,101.521857252514835,3187.000000000000000,3,858,2,50.0000000,621,1,25.0000000,850,858
4751,4.000000000000000,0.000277777777778,619,2510,1891,1121.250000000000000,802.246961664548735,4485.000000000000000,4,619,1,25.0000000,619,1,25.0000000,661,2510
4752,4.000000000000000,0.000277777777778,129,565,436,409.750000000000000,166.435235151694968,1639.000000000000000,4,129,1,25.0000000,129,1,25.0000000,471,565
4753,4.000000000000000,0.000277777777778,0,351,351,123.250000000000000,143.703470730529006,493.000000000000000,3,0,2,50.0000000,142,1,25.0000000,0,351
4754,4.000000000000000,0.000277777777778,266,1023,757,662.500000000000000,302.747832362182237,2650.000000000000000,4,266,1,25.0000000,266,1,25.0000000,482,1023
4755,4.000000000000000,0.000277777777778,0,275,275,68.750000000000000,119.078493020360312,275.000000000000000,2,0,3,75.0000000,275,1,25.0000000,0,275
4756,4.000000000000000,0.000277777777778,603,2952,2349,1239.500000000000000,989.734939264043646,4958.000000000000000,4,603,1,25.0000000,603,1,25.0000000,673,2952
4757,3.000000000000000,0.000208333333333,540,1468,928,970.000000000000000,381.893527919322878,2910.000000000000000,3,540,1,33.3333015,540,1,33.3333015,902,1468
4758,4.000000000000000,0.000277777777778,35,522,487,203.750000000000000,196.457851713796373,815.000000000000000,4,35,1,25.0000000,35,1,25.0000000,47,522
4759,4.000000000000000,0.000277777777778,451,3422,2971,1230.000000000000000,1265.912121752533039,4920.000000000000000,4,451,1,25.0000000,451,1,25.0000000,515,3422
4760,4.000000000000000,0.000277777777778,0,289,289,114.500000000000000,122.107534575062161,458.000000000000000,3,0,2,50.0000000,169,1,25.0000000,0,289
